ENCODE
VUOwvLKWMm: uZfKeVXEDt HKCrRjmmHt
uZfKeVXEDt: EskDVoVGeL hMxGZYvKeR
HKCrRjmmHt: lGbsWnbbVU MvljqjukpU
EskDVoVGeL: lRNunDdAcH mnSVypGpiN
hMxGZYvKeR: iIkoDSaaZy jGlaYVeZHS
lGbsWnbbVU: ZlpRVhzDFh KSlYnpyeEY
MvljqjukpU: EVIpIQQgAC CCPDuKlZvd
lRNunDdAcH: joEoXtahNd rzwPajApeu
mnSVypGpiN: hrArKLjenT LdBSVphpvD
iIkoDSaaZy: RHKYzKhqyb KgwuPzsdVU
jGlaYVeZHS: yHAxOEPXnY rcvZOmHqFB
ZlpRVhzDFh: ZQIPkyazet ONaMvZabgy
KSlYnpyeEY: fTeqZjQojM oLdNqrRwQX
EVIpIQQgAC: FeUydsEVlS RVnMTUSVHi
CCPDuKlZvd: NVOnYpzijf VTmpGwkaCo
joEoXtahNd: PvytYzduOb EhqlzElWod
rzwPajApeu: slYtyuLqdl gRweSSsJQv
hrArKLjenT: XEqXbVbPBP hLBDLZoJuP
LdBSVphpvD: QUchbpUSzR yxyaalUpBj
RHKYzKhqyb: YgChgoExAr ZxBQXWkiDZ
KgwuPzsdVU: KHUDqktuNl mkzxfMsfmN
yHAxOEPXnY: KDFNPGbiFL eWBbRHArOF
rcvZOmHqFB: mdoegrrkgS GrFeGReTHM
ZQIPkyazet: OlnubBfMSL KXlsVAAxKg
ONaMvZabgy: bdtAorWGIy hqOzoksaYb
fTeqZjQojM: gztNHnlSWx BLqeUSQCWT
oLdNqrRwQX: qfPYfZPAtU EVBINtsnMm
FeUydsEVlS: XgPopMrrig GyewPdSLJh
RVnMTUSVHi: kXohceWEQk ViHZnJHeBR
NVOnYpzijf: zTHJqBXZeo AXeMEfJGyV
VTmpGwkaCo: ePvGKxpDbW bFuAtjTClS
PvytYzduOb: ALQMecJbZJ baaJOvJEZV
EhqlzElWod: oTlrlderpI lDGJXGAZty
slYtyuLqdl: hnWniVZTOP ceeeVKeLxr
gRweSSsJQv: koPZbiyMOq HXJsFfEvhq
XEqXbVbPBP: JgwTMwpQzo TEWUBSbqzD
hLBDLZoJuP: VCWpuljAOb eSXpYdEbNt
QUchbpUSzR: eaSEvIBAmK mWUzJFEqyt
yxyaalUpBj: NsnfFnMaAj umWJIiZlAI
YgChgoExAr: cFzHiRmWWL PLyxFzdVSH
ZxBQXWkiDZ: hYHdcnEHsS gxEUMYrxVp
KHUDqktuNl: XKHVSSLELh LLhraDrUlQ
mkzxfMsfmN: ugBoaphbkX hgRFHXsTvU
KDFNPGbiFL: plBoaiCSdr laSaILcDyM
eWBbRHArOF: ECUMIoLTVS LKvtRFWzZV
mdoegrrkgS: kzTBkRpDiy vmjusktBRD
GrFeGReTHM: ptzOLzgJfu WcXrEbudmx
OlnubBfMSL: Rrnlfqlyeg vbmUDHqWVG
KXlsVAAxKg: HTlVHqpUEQ dKjeNjVvbu
bdtAorWGIy: vinyEZszpw pcIfDsWMqm
hqOzoksaYb: HGDcfLlKXr yDVxNRggoQ
gztNHnlSWx: UCKZdAsiJS ILVdoepFAu
BLqeUSQCWT: NJhZpJCNwJ lhdNOfuFIJ
qfPYfZPAtU: bfRJVPimuh NxATJzpzFJ
EVBINtsnMm: UGFlusoLJI ITSvdNVtBp
XgPopMrrig: WCRoiPgOki ScUtRDayhb
GyewPdSLJh: jBDWlemcUC xlZonCdKhJ
kXohceWEQk: ieJOFqTGyi UfWvtcwqLQ
ViHZnJHeBR: zFnBpZrZYc XBcPngZCis
zTHJqBXZeo: LDajElVZnf QCWEdHHgPs
AXeMEfJGyV: QBIOlwHVuW kcfyMujfDF
ePvGKxpDbW: ZjJJmJlECy JKsyiaHPHW
bFuAtjTClS: TeTuXQimsK TmTXusfnVq
ALQMecJbZJ: OuIyiFmbcf mXPVxdpIjR
baaJOvJEZV: xVwqDfARwC XoHqzUXOFk
oTlrlderpI: ivqJTiMTZw SAWZhRlRKz
lDGJXGAZty: StjYpiKnjn ZLwqbJdOVX
hnWniVZTOP: GvvAkcSNlX yelJkCKxxI
ceeeVKeLxr: piDwNByPqi pvjgvNViMZ
koPZbiyMOq: SemmSkzzgw NjfXcGsvlU
HXJsFfEvhq: wmemXeDXlz evwvCrEQtD
JgwTMwpQzo: PGxoNrcxkd EyIPeQJMQb
TEWUBSbqzD: yvnWwHSpWd doDydzoILu
VCWpuljAOb: ciABpMMvrg onTbqaGKds
eSXpYdEbNt: fITsNfFdvs iOldUqrMQa
eaSEvIBAmK: oLmSmNyEIS TOpERfNmuS
mWUzJFEqyt: YPZBcuDhgn RvrCeiLmjg
NsnfFnMaAj: SUuyEiDWDx RFXAOTyqJD
umWJIiZlAI: CVgWlNcMEj mQQUvcQMAu
cFzHiRmWWL: IbtmJwjXPT fFVbGZclxT
PLyxFzdVSH: TTEtBQWtZY SugJTpDKVs
hYHdcnEHsS: oAkVuDXPbz bvcGHSMqzL
gxEUMYrxVp: AzOsXobzQD HfJnJDGrSe
XKHVSSLELh: SYsbyUdXMZ DouhdGvhIV
LLhraDrUlQ: pRZSFoYivg ecoKpnRUGB
ugBoaphbkX: nlKVETKPEm AkRNkFOWuQ
hgRFHXsTvU: dYZpYPYocf qhGogdHTNL
plBoaiCSdr: rYTwcONObd IvfiIgmFMZ
laSaILcDyM: MrfYeSmRhW oUQgbJcSth
ECUMIoLTVS: JiRjBjEsBN KRqGkGIBaF
LKvtRFWzZV: EKtpamvzDS vWywMQYMJE
kzTBkRpDiy: ELTbjAcOcm AYDBtyrdwb
vmjusktBRD: puuksqTPrT tEflNjqKda
ptzOLzgJfu: lYVISSqrYE IfUMHNOZcx
WcXrEbudmx: XBYCDGueoc WnvTmIIVTN
Rrnlfqlyeg: EwEvmcqgws SYhlKfSeGY
vbmUDHqWVG: kQVTyJyrtc yUbfAnFBho
HTlVHqpUEQ: XbsDiensty asAmawoIER
dKjeNjVvbu: DyShaWNVZx MZJkUJCtfG
vinyEZszpw: YJWJOIMjsc jUCdkobwRm
pcIfDsWMqm: UCyZrDIThJ xyAMLhsFGo
HGDcfLlKXr: PhCoJKkZGi pdrOaieVkx
yDVxNRggoQ: bJxEVEpHtX SnNVkQvVfB
UCKZdAsiJS: TLiTDxjMjf icdtvXaISX
ILVdoepFAu: PtxUyGEQhW zBVerXLXQN
NJhZpJCNwJ: ZkokcbWPIA QSRtuWTWtp
lhdNOfuFIJ: RcOUTdcsfV YoPHQDyDPQ
bfRJVPimuh: hJuEsuslnW vhqxyocjeS
NxATJzpzFJ: EHciNEkdht tLREZiwUIs
UGFlusoLJI: OLadhuvWhX oAFAmHwUoz
ITSvdNVtBp: jdbGqOaxuZ wtmQTclYuh
WCRoiPgOki: FKNbdojfGM NOHzPFPNtV
ScUtRDayhb: mrwApNERqc mzTmpOwrfL
jBDWlemcUC: QCWIkeZZOc tOfMHfltXT
xlZonCdKhJ: mcFznuKMUy bOUpoUyKwL
ieJOFqTGyi: hRduQnQAzw nqfiGnUEEK
UfWvtcwqLQ: vOLZlCxuai GkcBLoqBVW
zFnBpZrZYc: GlUNazRgJr qVDbPRGPcY
XBcPngZCis: UrRHpLlRnU xDJKvseNid
LDajElVZnf: oORkZMhOlP gqOsChKLJz
QCWEdHHgPs: IjCKiKoKCf ZUTXDaeard
QBIOlwHVuW: HhHHxOUGDH HONgAiCfee
kcfyMujfDF: hZzPqpwHXS jSCySiNgmC
ZjJJmJlECy: WqmoOeBTXz tncJSgQyvg
JKsyiaHPHW: AruFYmXFnO uRhPDdTEri
TeTuXQimsK: SxOtSsfJBB uGOqwMZNXV
TmTXusfnVq: kjYYZWrpDD DktLSbAvXl
OuIyiFmbcf: VAeLwxTQKz hsrKzgoeku
mXPVxdpIjR: jglktvEvaq WpkkpXhexE
xVwqDfARwC: hKhCLMFpti dBKfyrblxo
XoHqzUXOFk: ppenvEbkVz mKEUwkdyWQ
ivqJTiMTZw: XDmIXbsIXG eiFcekjFWP
SAWZhRlRKz: gluWDbQioC CJJtnbkSvS
StjYpiKnjn: RKRetuQKDB QWATgmhGEo
ZLwqbJdOVX: NzftcxAmqo eCQqSLwupm
GvvAkcSNlX: eQoArHrJWj hyInftNEdS
yelJkCKxxI: yZaTgnUDvP GQQwtTTnNL
piDwNByPqi: RfPtAdnuTD oZgLAjkcgR
pvjgvNViMZ: hpGraanqWI uLDedCBhkQ
SemmSkzzgw: LGlZbLKBzI nDZpATsvqY
NjfXcGsvlU: ZvgWmyqOmj zXZjucjipC
wmemXeDXlz: mfbOEdkGbo ygQuFiUYdJ
evwvCrEQtD: HhfXxBNkPq NFMSVkmIER
PGxoNrcxkd: BaPessLohA gOhAEssxKm
EyIPeQJMQb: YOEdNpxSsI EubqhxXehY
yvnWwHSpWd: huKKIPufGY DZQVvOgonm
doDydzoILu: DXIGRYVuDU hMHzmlEYOE
ciABpMMvrg: bcsbiVbKPb GCgSYPOVow
onTbqaGKds: NFjkDedAnA GBqYqVThvX
fITsNfFdvs: ByBaSGZDRW bFakeMgKJT
iOldUqrMQa: wmpvJdsHNL uzDujkOlos
oLmSmNyEIS: AAPfBNIUqS uskzRiVhxM
TOpERfNmuS: MqhdhAaife iDbFUGYBuA
YPZBcuDhgn: zgAmYlembW uhPGZNiYwm
RvrCeiLmjg: yHRfGMvONL wDuXmPoQbA
SUuyEiDWDx: HPwDLeDBAY KKoUVGhpYH
RFXAOTyqJD: cEYGEdNYLt kpuqXcoznD
CVgWlNcMEj: ePnAHEiGNT KYntHXtFyh
mQQUvcQMAu: lqbuCuShrG WWrVjycYjs
IbtmJwjXPT: NehxGbEuUU HtfIPgCBLR
fFVbGZclxT: ijaABrrWdV kqzDQIwbfN
TTEtBQWtZY: wHvDtLoVtu BeVBEtdfpS
SugJTpDKVs: fLgrgBqdyt ZnatvjQUyp
oAkVuDXPbz: qAybaAkySF rCZMuJyRao
bvcGHSMqzL: PVsLpiyujH IGrNkdapxQ
AzOsXobzQD: AWZujZwjkt zcPOJmSjtK
HfJnJDGrSe: uxBphZZBQV TIccDeHZVg
SYsbyUdXMZ: fUxyBpTFpQ vxnbsTAWMs
DouhdGvhIV: etTIFZiTRu MUhzETXtxW
pRZSFoYivg: ucNfRqdCFL FofJlHcmQH
ecoKpnRUGB: LwrBodupJu vrvtEVGBVQ
nlKVETKPEm: DgpjSznlnY rtLXLhMFTM
AkRNkFOWuQ: FmJitYpiPh XNdAXieqiD
dYZpYPYocf: oVbnaNaBnm tWXcENpnZu
qhGogdHTNL: KrqzTsSrPq NOarROyYha
rYTwcONObd: kVqHGKMFYC vwciwdLlhZ
IvfiIgmFMZ: oGrDlGroad EPTopMcarR
MrfYeSmRhW: hLwzfKBwxM aSKmysRPyP
oUQgbJcSth: wEoNaypTue jzMIlKugAH
JiRjBjEsBN: IKKNMmbMjs YMKdySDwLk
KRqGkGIBaF: dfuZZxbatR rIrkeNNCvA
EKtpamvzDS: uhiMAHkgqX gvzoBoiOyh
vWywMQYMJE: lqzpRIOksl WDatmiTWwq
ELTbjAcOcm: MREosjnkTo JKbEUERMlz
AYDBtyrdwb: MUqJzVJpKZ jTKXRqtURj
puuksqTPrT: VFPXVmKLHU jLaWoOBvgP
tEflNjqKda: anRJBJMTdB zalhGLggAr
lYVISSqrYE: hDjmShdEfy vQHJLNyuKp
IfUMHNOZcx: fPpTUiMAYc tyfaNIZTbL
XBYCDGueoc: hfAJnBuSJF tmIsBiyYMg
WnvTmIIVTN: mTmLUFneSR RZMpOalkTp
EwEvmcqgws: tBeZFtFHZg AKOHYRjMjg
SYhlKfSeGY: YceAlrnllb ejElxezugn
kQVTyJyrtc: bngeCMacwP stBTaWiYmo
yUbfAnFBho: zLfKaLQTYG ROpKBtgnWT
XbsDiensty: vgGpXyzJAJ DyQWHNkWMS
asAmawoIER: tXdchApqec joZpUsLHwA
DyShaWNVZx: NQkCkSRHKN FHuOKaoytX
MZJkUJCtfG: czSXiMadxp MYVlYVeGfC
YJWJOIMjsc: CWGFJAicET nwmzjlrQCf
jUCdkobwRm: aurkPSLuuP viUFUDmOFS
UCyZrDIThJ: vsatovKuRT EBJvABfBWT
xyAMLhsFGo: VjgHSgFEuO mzyUTcgpKs
PhCoJKkZGi: bgftnAIDgP ESlqAYqSXa
pdrOaieVkx: ZeTlVfETDv SLlCyPzeBr
bJxEVEpHtX: zQjHqAzArf wscNswAcYB
SnNVkQvVfB: taznhwVqrg odaZVaHwew
TLiTDxjMjf: TZDlRlDFwe FAbXZxenCB
icdtvXaISX: BaBRoqUNmj nfRFxSbunf
PtxUyGEQhW: xbCczfWMOw xoEoMmGOuz
zBVerXLXQN: PFULBrbndF wnrLSZrYce
ZkokcbWPIA: PxcvOjYqvM PsCkypfjbP
QSRtuWTWtp: TPKaaiBvum XNwaiCInHu
RcOUTdcsfV: MvcuPenodW hmXcDAWFcJ
YoPHQDyDPQ: HtIfZqwErq TucNzsRyrT
hJuEsuslnW: sygesbVNjd jAJIlyZIKJ
vhqxyocjeS: GWKSzaxahD yvebSTxGcu
EHciNEkdht: bxgsrAvsIX PrvkRHyapx
tLREZiwUIs: rwCvGDMPHu QvsbPZiDqh
OLadhuvWhX: xJtgkOMToj rbgbieiXJZ
oAFAmHwUoz: ytJeqdyxjn yzadRWFJTi
jdbGqOaxuZ: mCuOUSrjoT xLXnmDHZef
wtmQTclYuh: sBwNfAuchx SySmPgZMFK
FKNbdojfGM: HlHwyHTuTq binWRPAAhd
NOHzPFPNtV: ZkCtetexgq ipfaDSSitZ
mrwApNERqc: zBaxVkGNAh jLmnPbJQQS
mzTmpOwrfL: MwdvCzALgq mqSlVIfKkc
QCWIkeZZOc: SmcdsUkcwJ epjscsHJZI
tOfMHfltXT: KGAfbpBQFQ GkCrkXhovL
mcFznuKMUy: MWSYIFnLjA kkBkQBvutP
bOUpoUyKwL: vJqrmfQBmX uybApvrZUc
hRduQnQAzw: PXttkOXfiP NlCrNtdREP
nqfiGnUEEK: zMuaDXnqPt DwAcMGcONO
vOLZlCxuai: pbMFJxVYLV zaGrZvAAEK
GkcBLoqBVW: ArBEIprkAx LjFhjiTcGS
GlUNazRgJr: dYEUtYOOgc cajnobTejE
qVDbPRGPcY: hVxQyeVenS MCBIFYOxcX
UrRHpLlRnU: lVKjEHLaOx XOAehPANks
xDJKvseNid: yDrAiqSknT vYLUQUezfM
oORkZMhOlP: SXRjRNJtMM elqomBVtpt
gqOsChKLJz: duaOraBZUE CxEZOYvBgf
IjCKiKoKCf: GWQLIHdIGM KMeEXDKeNz
ZUTXDaeard: czrZTPCXYI veelvPIXxt
HhHHxOUGDH: PGmkzzQEEm FheSlWksZc
HONgAiCfee: zLFBAlQUfW misAahJRqu
hZzPqpwHXS: DAxLNvxfRN cVHEikBIyV
jSCySiNgmC: zzteSmZEog YzgnxndcXL
WqmoOeBTXz: cnbVoulWrN oKaBBkNlZs
tncJSgQyvg: BMRrofLjdj JpTHxdaADH
AruFYmXFnO: OdLgprFTNv cNWccRKNXW
uRhPDdTEri: YFHDQMyADZ ZDETtDyKZZ
SxOtSsfJBB: qTROLpJIsq grCvqMLawp
uGOqwMZNXV: OJvLqHHgMK ohLqQELmzf
kjYYZWrpDD: xNYssftwbu mzqPSxHkrJ
DktLSbAvXl: LxzdzeTiFi bIMZghbsfc
VAeLwxTQKz: CCYOGdpUoA UDwFXLkiLP
hsrKzgoeku: nsGKtfVAHB WLUMgwxbbc
jglktvEvaq: NYEixTOhWA sclroqmnKH
WpkkpXhexE: VWHpdPWpki SnAEcchKMp
hKhCLMFpti: jNNOwuhrAO nQjdoKcxkR
dBKfyrblxo: kYbErRFSnv FWImDYOgHo
ppenvEbkVz: pRyUFhkXrf hQJERZlQfO
mKEUwkdyWQ: SBokLBguWH PXCHDPJKJe
XDmIXbsIXG: QhCnxpErLS XclcSGhAEi
eiFcekjFWP: GqZuzOySmW DkDeLXeUvp
gluWDbQioC: osQXpKVgSe wSdKFTioQt
CJJtnbkSvS: RJLqrFRilu ONkNFnXmNX
RKRetuQKDB: EHPbKxwBHR OeEIzZYJuF
QWATgmhGEo: NwGtxNFriA kefJwdVEST
NzftcxAmqo: OrVvrRGjVu JQKQTFJWle
eCQqSLwupm: OBLoeQomSS WQyVGedwjE
eQoArHrJWj: CwPjhTAZIe IreADojXRm
hyInftNEdS: GqJGZxMPRK ajtzWMslRB
yZaTgnUDvP: hdKMOslwsb KKlTwDyJXv
GQQwtTTnNL: tGePckBHHJ blRikqfQdx
RfPtAdnuTD: yQfLtDTpSj ILuqUHjzgr
oZgLAjkcgR: tbxlrEYeGl QcMnuZfGWy
hpGraanqWI: wKaKTkghkg bZDOcRrbxv
uLDedCBhkQ: tUMgDQTsQi gxSVIVtXTE
LGlZbLKBzI: CiEgunjQdd NplRoVdhVa
nDZpATsvqY: SDBkHYrwzn BYwgbNHKfU
ZvgWmyqOmj: VPzPyLYrct zPQLZzqgYZ
zXZjucjipC: lbRzUlXPEM GenzJCLgyr
mfbOEdkGbo: XzbfyJjPWy fADuzjcXfR
ygQuFiUYdJ: OHDikzFrVt ZoNfINiSid
HhfXxBNkPq: arNswONxfE retZpfkFzZ
NFMSVkmIER: BZroCSxFPf xaiHuaxWti
BaPessLohA: RprpVAhbBG miCezBHgwf
gOhAEssxKm: CtGwAuMHtU kwbskwNrVQ
YOEdNpxSsI: vJetIcoqRl UnaHgGctkD
EubqhxXehY: epgPnHRWXY vLCDxucLMb
huKKIPufGY: XCmPhGEmBh QDlQSvqdzE
DZQVvOgonm: UDQQISKJot xFhwhWswKn
DXIGRYVuDU: fpmXmdebwh aRYyTDMcFr
hMHzmlEYOE: olWDTDPOxF fibVYGeKWb
bcsbiVbKPb: bXvfsbRigb tthPRVlfOB
GCgSYPOVow: WZpsRvWQau JbUqrFpaYe
NFjkDedAnA: ECWnMTVBfI tZgoaRbwWK
GBqYqVThvX: cjizEqRnCD DJDixbodOL
