ENCODE
cKFruCjVza: gfLhDqLeyp
gfLhDqLeyp: LAMHrEBAPg
LAMHrEBAPg: QhEUmHrdZp
QhEUmHrdZp: BPTWeSfaoD
BPTWeSfaoD: aRfEkFeccb
aRfEkFeccb: jQgabycZKW
jQgabycZKW: sioDOpTIlC
sioDOpTIlC: qeLRXUeTyO
qeLRXUeTyO: ZHNvCvZyHC
ZHNvCvZyHC: PwnPtpSPLd
PwnPtpSPLd: RSxgeduEta
RSxgeduEta: AHJsTySdoq
AHJsTySdoq: oujEARbXzN
oujEARbXzN: ZiWWWObrOp
ZiWWWObrOp: aTBWDhRzYF
aTBWDhRzYF: xLTNeZjbTW
xLTNeZjbTW: tOHguXuKwJ
tOHguXuKwJ: JuGdOxowYx
JuGdOxowYx: AJKfnYPfZF
AJKfnYPfZF: rYezGSzNXY
rYezGSzNXY: fWznrmBBQC
fWznrmBBQC: aRYKfvNgyq
aRYKfvNgyq: shgUOFevRh
shgUOFevRh: pPqrJnIINh
pPqrJnIINh: qmCtkkDPFX
qmCtkkDPFX: rjrQcoIoow
rjrQcoIoow: kbQKXeIaVG
kbQKXeIaVG: LyDIrLxmRf
LyDIrLxmRf: NgZwmhOKGc
NgZwmhOKGc: UXUrBSpTwt
UXUrBSpTwt: yhyxwcuBQl
yhyxwcuBQl: jToIjxcnqu
jToIjxcnqu: KhDTKLUKJc
KhDTKLUKJc: IVYsyQvSrk
IVYsyQvSrk: TFQiLQSTfe
TFQiLQSTfe: TUsIkkYrXe
TUsIkkYrXe: nWyHVpaLdB
nWyHVpaLdB: QZcmFyvOpv
QZcmFyvOpv: QbpgKzbrKT
QbpgKzbrKT: bBpyymSbqn
bBpyymSbqn: yhsBDfMdIW
yhsBDfMdIW: GIGvHcFvJs
GIGvHcFvJs: LBRDVIwvFc
LBRDVIwvFc: RVMNNORljK
RVMNNORljK: UJcHzXogsD
UJcHzXogsD: AxROVBIYrE
AxROVBIYrE: BTFLZfsMpL
BTFLZfsMpL: byNoJbZcFV
byNoJbZcFV: GwHjyBKSWO
GwHjyBKSWO: tnXjWeZQjg
tnXjWeZQjg: WywuCanYEi
WywuCanYEi: UIzSqAlIWv
UIzSqAlIWv: XTnelTfYjC
XTnelTfYjC: UgjdqKJCDl
UgjdqKJCDl: GGaBpxCCTt
GGaBpxCCTt: ECpbkmULSY
ECpbkmULSY: JvYjxPxcQI
JvYjxPxcQI: KJGxKzmtXk
KJGxKzmtXk: cOsghRtDRZ
cOsghRtDRZ: zpPPnCOgTO
zpPPnCOgTO: pnmKPhlRPf
pnmKPhlRPf: ymGLHizcxl
ymGLHizcxl: uVmFyTaOPG
uVmFyTaOPG: PPISkxJJJQ
PPISkxJJJQ: yGDckRagvj
yGDckRagvj: ZiJrKMuwNO
ZiJrKMuwNO: pMlWbtgIoU
pMlWbtgIoU: YWtecFNWXK
YWtecFNWXK: cUprRcvvhP
cUprRcvvhP: FxkRGpBhZg
FxkRGpBhZg: gQDlosNnxS
gQDlosNnxS: UljFmHpbRf
UljFmHpbRf: wdrGsKEQiE
wdrGsKEQiE: hYMbPbFbWF
hYMbPbFbWF: OsAFwjDUrh
OsAFwjDUrh: colKMbnjdt
colKMbnjdt: mFYIAyahRM
mFYIAyahRM: BBrdbWgVBZ
BBrdbWgVBZ: YbxRnAdndd
YbxRnAdndd: SGBtSElRTD
SGBtSElRTD: ojHjVeWVLE
ojHjVeWVLE: BpatTTFjKl
BpatTTFjKl: bNcdzxWAoC
bNcdzxWAoC: hHIKWvRSYL
hHIKWvRSYL: WBMkCcBltS
WBMkCcBltS: RWObXAeZJM
RWObXAeZJM: fXVrjPfhqd
fXVrjPfhqd: EPsUInoysl
EPsUInoysl: DnEkZmeBkc
DnEkZmeBkc: kCPAmHImqK
kCPAmHImqK: OFQdBadGsA
OFQdBadGsA: UuGuwgStXL
UuGuwgStXL: mkNNpyKzHE
mkNNpyKzHE: gfHPVeNniQ
gfHPVeNniQ: zfGUUuTUkD
zfGUUuTUkD: MbKsmwKrJe
MbKsmwKrJe: whnQJdvTcv
whnQJdvTcv: BWLwSNWpqX
BWLwSNWpqX: aJKURYeEMa
aJKURYeEMa: DeiqvxerMO
DeiqvxerMO: nlmfUYqhtt
nlmfUYqhtt: sjguNDDgvz
sjguNDDgvz: RNskcPDvGo
RNskcPDvGo: fsrmtBLGFv
fsrmtBLGFv: eIivWOeFxc
eIivWOeFxc: BKrLNRAUwo
BKrLNRAUwo: iyqZJEZAVf
iyqZJEZAVf: bJeAAvdyqd
bJeAAvdyqd: MNDfLxulNP
MNDfLxulNP: mjxXDipoDj
mjxXDipoDj: yxCFQHowzk
yxCFQHowzk: zqbeoZoBFn
zqbeoZoBFn: AqRNvsAfgT
AqRNvsAfgT: MUZxxDvjoW
MUZxxDvjoW: hibyNazfvL
hibyNazfvL: lnvpNHadFZ
lnvpNHadFZ: wPkcjaIyBh
wPkcjaIyBh: vjFiWQPeNQ
vjFiWQPeNQ: xgnUtgzPnO
xgnUtgzPnO: eueuGeifbP
eueuGeifbP: YbXXhpOCCw
YbXXhpOCCw: vcBELiDywx
vcBELiDywx: IfYGgQpjEP
IfYGgQpjEP: upsOYefzyj
upsOYefzyj: FeYQznCnpc
FeYQznCnpc: azvCFyZiiF
azvCFyZiiF: dMBZNSUJMi
dMBZNSUJMi: hiCXYaEYrY
hiCXYaEYrY: TdQbcuYEBI
TdQbcuYEBI: cpwHKcgfNU
cpwHKcgfNU: DYqGOjbfPP
DYqGOjbfPP: lbEVeFFzAW
lbEVeFFzAW: FRguSuwFni
FRguSuwFni: TNMhhLWJAX
TNMhhLWJAX: BKwxJCJdPM
BKwxJCJdPM: mdTywiwslP
mdTywiwslP: fIYLCaqOpV
fIYLCaqOpV: cAWienSmkD
cAWienSmkD: dxEPzHVCRq
dxEPzHVCRq: YFuhFNjIgc
YFuhFNjIgc: yMdsdGAXxy
yMdsdGAXxy: ZEekTCQCWk
ZEekTCQCWk: IKuBEPrKij
IKuBEPrKij: RsMdOqyEDa
RsMdOqyEDa: fIzmaHFPbV
fIzmaHFPbV: FSVWmtSXBg
FSVWmtSXBg: zKAPowMORx
zKAPowMORx: OKrClRAFKi
OKrClRAFKi: KaSNFnPyjA
KaSNFnPyjA: SzvuFTkVjj
SzvuFTkVjj: YGfHagEiiK
YGfHagEiiK: JgJBJeznCc
JgJBJeznCc: japttZgakT
japttZgakT: EDnccVuRoB
EDnccVuRoB: bcMkfAYsvl
bcMkfAYsvl: ZdyziJCVNI
ZdyziJCVNI: azBHwdXpNw
azBHwdXpNw: HouBdDUnyS
HouBdDUnyS: yGfCHFvdkV
yGfCHFvdkV: XpVeAchpRT
XpVeAchpRT: xgjrYtnWcp
xgjrYtnWcp: frrJCtNjdk
frrJCtNjdk: LCrkdvjEmc
LCrkdvjEmc: tuWSuRARki
tuWSuRARki: fzHxUjYqLp
fzHxUjYqLp: EUFPnSZlUF
EUFPnSZlUF: IeYQediRYy
IeYQediRYy: XrmihZjsBF
XrmihZjsBF: twDPGlvuwt
twDPGlvuwt: SKbQRsHCzk
SKbQRsHCzk: TklFgpFQJD
TklFgpFQJD: CdKJodHocZ
CdKJodHocZ: cMwYKojtDA
cMwYKojtDA: BWEIVjPukS
BWEIVjPukS: zFpQdRaphx
zFpQdRaphx: cTPLRdAijb
cTPLRdAijb: LjAqlzCZyb
LjAqlzCZyb: PsxZTIdVhs
PsxZTIdVhs: jRiwZIGkuC
jRiwZIGkuC: PLYvDDIWCW
PLYvDDIWCW: GdOgpRuhdx
GdOgpRuhdx: iINgLXRoQJ
iINgLXRoQJ: EmFYhAQTJs
EmFYhAQTJs: vyIBoVScTc
vyIBoVScTc: ydmHzIidWM
ydmHzIidWM: VRnNKuKjlo
VRnNKuKjlo: GEaQjRRfrq
GEaQjRRfrq: sVfZtsJuSd
sVfZtsJuSd: NYPYcvGiHF
NYPYcvGiHF: SJywuXqoQw
SJywuXqoQw: ALWAEadCTz
ALWAEadCTz: WQceVQcKfX
WQceVQcKfX: KNCTxnchlO
KNCTxnchlO: zhPvRwrobg
zhPvRwrobg: gObXDmxEun
gObXDmxEun: swCSnOqAPm
swCSnOqAPm: ygVjEAwpIn
ygVjEAwpIn: PnxAGLtCpa
PnxAGLtCpa: HiKQBqqcIX
HiKQBqqcIX: KrZcPHxSas
KrZcPHxSas: uNDqkMQGYY
uNDqkMQGYY: TRITDXQEjB
TRITDXQEjB: LdYCwPahDm
LdYCwPahDm: EPpinMQgkB
EPpinMQgkB: RAncjlwAzb
RAncjlwAzb: MTIgyyIMPc
MTIgyyIMPc: WcHKdNYLLZ
WcHKdNYLLZ: lLkXMsOFRp
lLkXMsOFRp: VIYYqRhwSB
VIYYqRhwSB: JaqxMfulyu
JaqxMfulyu: hKPuiZKSYA
hKPuiZKSYA: UHGNuyHzEA
UHGNuyHzEA: nBPoiaaeIF
nBPoiaaeIF: DHOfzXIFTY
DHOfzXIFTY: oxUNMJPFEF
oxUNMJPFEF: jxryZORtOx
jxryZORtOx: ElkqTDgLza
ElkqTDgLza: LQgAIBLBVb
LQgAIBLBVb: fxyXjJdEFw
fxyXjJdEFw: PSjGvfjGie
PSjGvfjGie: ijbtZUDoRd
ijbtZUDoRd: UYQdJOLLTq
UYQdJOLLTq: imVjfZFtbQ
imVjfZFtbQ: SaUgdMfIKn
SaUgdMfIKn: fUdpaoHAFE
fUdpaoHAFE: gWGZalUqqT
gWGZalUqqT: fCuPMqLsVc
fCuPMqLsVc: QNKCnMoIwz
QNKCnMoIwz: UKgptsTjQg
UKgptsTjQg: SezaSQMfvl
SezaSQMfvl: KYgCFebzZm
KYgCFebzZm: tCBcqPJVBh
tCBcqPJVBh: cQcHSpHIsJ
cQcHSpHIsJ: NeijqIHIHq
NeijqIHIHq: zSywRdnPKB
zSywRdnPKB: axBkVyLwGB
axBkVyLwGB: NwSplVbHtr
NwSplVbHtr: lZsWauwjOx
lZsWauwjOx: mCxIpWzVwe
mCxIpWzVwe: UVppfbmIOb
UVppfbmIOb: NKhcUacwPN
NKhcUacwPN: WrHHoGeGBG
WrHHoGeGBG: LfsbzKvjNM
LfsbzKvjNM: iPjQEoYqYe
iPjQEoYqYe: gbsjUOpjcO
gbsjUOpjcO: vZfNntgoRX
vZfNntgoRX: zZLHITnCin
zZLHITnCin: sYkfkufXYu
sYkfkufXYu: eOZRzvrvaC
eOZRzvrvaC: GmavIjfhPZ
GmavIjfhPZ: ZENpKpRLtS
ZENpKpRLtS: GLeXTLEaot
GLeXTLEaot: hUYdEInMUt
hUYdEInMUt: qYBjKtPKTy
qYBjKtPKTy: MpTuYSEzjr
MpTuYSEzjr: klnThCFuDC
klnThCFuDC: vtDhwucpeI
vtDhwucpeI: wJFsgAzwFZ
wJFsgAzwFZ: IwOychTqHp
IwOychTqHp: sqoICziYki
sqoICziYki: zXkypSQlRI
zXkypSQlRI: vaKQLjQLCb
vaKQLjQLCb: ekbTihJwiH
ekbTihJwiH: biDLYiTmfd
biDLYiTmfd: RJTcmbFdeh
RJTcmbFdeh: tfQgADbhVX
tfQgADbhVX: eBIBExPLnH
eBIBExPLnH: CbsHyxSpqb
CbsHyxSpqb: sruoEPNyfP
sruoEPNyfP: PBaPyHUHRF
PBaPyHUHRF: hTpsiyOjxK
hTpsiyOjxK: oCcOdyKylw
oCcOdyKylw: FcWWJGJzRp
FcWWJGJzRp: oWVaFJaRrk
oWVaFJaRrk: zVILTNSxGl
zVILTNSxGl: HaUREohJlt
HaUREohJlt: sXdckDztEe
sXdckDztEe: qhotaRidrO
qhotaRidrO: HbjnNjDIGM
HbjnNjDIGM: WlGtoGJRFL
WlGtoGJRFL: LCiFBeGIlE
LCiFBeGIlE: CyaMbeQovo
CyaMbeQovo: vwWRpgrGhq
vwWRpgrGhq: VWSlQVyzrI
VWSlQVyzrI: zXupnFLTkY
zXupnFLTkY: rFRAZuMtti
rFRAZuMtti: bNZafYEMkR
bNZafYEMkR: lTeFKfEtKW
lTeFKfEtKW: uFgRVFvIVb
uFgRVFvIVb: zINbbzVeor
zINbbzVeor: rPKTeyjMiz
rPKTeyjMiz: lsgiBvoLoc
lsgiBvoLoc: KFJWaNDExy
KFJWaNDExy: SHrJpTRJMy
SHrJpTRJMy: PzbJyiSvDM
PzbJyiSvDM: OVVZUAaqoW
OVVZUAaqoW: aMJNPVctUd
aMJNPVctUd: WtZvUWYDeN
WtZvUWYDeN: RjceUUZqCJ
RjceUUZqCJ: gteEVqhxlA
gteEVqhxlA: rgFyrRIHjU
rgFyrRIHjU: PaBEESlQPr
PaBEESlQPr: AhEpGDRDed
AhEpGDRDed: lEfTzhSrPm
lEfTzhSrPm: CZuKCVYHIQ
CZuKCVYHIQ: RSZVaYoJwW
RSZVaYoJwW: xruOKtzBJj
xruOKtzBJj: bpXNeXYmhS
bpXNeXYmhS: YpcAccRBlx
YpcAccRBlx: RTqovXlgwH
RTqovXlgwH: rHgodDdntA
rHgodDdntA: fnYyKnTDLS
fnYyKnTDLS: DbHqWJrVJl
DbHqWJrVJl: sxMUnUhNpb
sxMUnUhNpb: XICYJpDCqE
XICYJpDCqE: BMWuFREGdk
BMWuFREGdk: krteAIuswl
krteAIuswl: KDhFzTOVtu
KDhFzTOVtu: YKpSujelhn
YKpSujelhn: HEwaBzVhwu
HEwaBzVhwu: XgkUPfjzLC
XgkUPfjzLC: nVwduUGwUj
nVwduUGwUj: nzjbCMxGam
nzjbCMxGam: ppMjjDyVYJ
ppMjjDyVYJ: XhNpopACXp
XhNpopACXp: kCpXdRbwkO
kCpXdRbwkO: qGdCAUsJcD
qGdCAUsJcD: mONTswgPLL
mONTswgPLL: cCjynixGBO
cCjynixGBO: JnlEvSfYHN
JnlEvSfYHN: MujsBUzDYW
MujsBUzDYW: crpZmEabXr
crpZmEabXr: NJSAbAhnWQ
NJSAbAhnWQ: vixcVSJWZw
vixcVSJWZw: AdTwTUxuEE
AdTwTUxuEE: KCtyEnAtvG
KCtyEnAtvG: RkAcmbtbEL
RkAcmbtbEL: pJaOUiazMy
pJaOUiazMy: oNIngoZzCi
oNIngoZzCi: XmtJhDsicQ
XmtJhDsicQ: grIhbnasIP
grIhbnasIP: TavHtveNMa
TavHtveNMa: IatKoZlhuN
IatKoZlhuN: bbOAnWvpLJ
bbOAnWvpLJ: fPUuZlmHvb
fPUuZlmHvb: sKuxElOCfM
sKuxElOCfM: IfaABTTkOP
IfaABTTkOP: SYCVgrGZCt
SYCVgrGZCt: GHbrBOSEzh
GHbrBOSEzh: rZomwRGfqU
rZomwRGfqU: YwEPezzsqU
YwEPezzsqU: olTaCzHeno
olTaCzHeno: mqOVyxqxQb
mqOVyxqxQb: YzgEOvANWP
YzgEOvANWP: RQbLvJAnww
RQbLvJAnww: PKxWujwYJE
PKxWujwYJE: gnlmRKoILe
gnlmRKoILe: BqLPoRpZZX
BqLPoRpZZX: EKvConEAqi
EKvConEAqi: FBAgTekXOQ
FBAgTekXOQ: CruXZFIkTm
CruXZFIkTm: kfMhKntfUX
kfMhKntfUX: ArHdQRbpLO
ArHdQRbpLO: gaHlLwzRYf
gaHlLwzRYf: cvYPNlrPDU
cvYPNlrPDU: OhdcauNAey
OhdcauNAey: YHhlysnZhx
YHhlysnZhx: ICzIKpxeYp
ICzIKpxeYp: AIDSPMrxKP
AIDSPMrxKP: wUztrjHDUT
wUztrjHDUT: btxmxAnPmI
btxmxAnPmI: dcuKhVrhIs
dcuKhVrhIs: nzdxiPlCUN
nzdxiPlCUN: XmvyanuxAO
XmvyanuxAO: FEWqUaiHnc
FEWqUaiHnc: HkNPSatuyy
HkNPSatuyy: EaCOyCHVGj
EaCOyCHVGj: VzSNgwHozC
VzSNgwHozC: DzjnPzXUYJ
DzjnPzXUYJ: kUoUkytPZy
kUoUkytPZy: UZxTbonmcv
UZxTbonmcv: qUoonhfEWG
qUoonhfEWG: ewAbDurAYV
ewAbDurAYV: jLFeAQowCj
jLFeAQowCj: XwWntEIWLS
XwWntEIWLS: fUdBAgGwkG
fUdBAgGwkG: FqkqQTHenj
FqkqQTHenj: tLnXbUwIAk
tLnXbUwIAk: YqzDqKTaNc
YqzDqKTaNc: HhCCYfyyZS
HhCCYfyyZS: oFyuqdSBXx
oFyuqdSBXx: oMUwZNUHHg
oMUwZNUHHg: tRPXKjiaNJ
tRPXKjiaNJ: IqAdKPUTxc
IqAdKPUTxc: WUKXxFJIug
WUKXxFJIug: TwhmqNmhOo
TwhmqNmhOo: XcfAZTYYHw
XcfAZTYYHw: oDaXlAzKTW
oDaXlAzKTW: GrIflloUDe
GrIflloUDe: LHvEDmBHbK
LHvEDmBHbK: dfukYMKUvE
dfukYMKUvE: txutbUyBak
txutbUyBak: fZJxjfIdAN
fZJxjfIdAN: AEsgnDGeYV
AEsgnDGeYV: bTDVSXVrBs
bTDVSXVrBs: GPVZefXPvx
GPVZefXPvx: ihTVfkLQNw
ihTVfkLQNw: VqhylJMcoD
VqhylJMcoD: JPSMqbJKwc
JPSMqbJKwc: bKNYSycWVR
bKNYSycWVR: CjuTmsoUkK
CjuTmsoUkK: XmgdIcgitt
XmgdIcgitt: IjDLYPFNvZ
IjDLYPFNvZ: hdGMEZJSVm
hdGMEZJSVm: ZBMuAQvzaD
ZBMuAQvzaD: bILqEgHMQD
bILqEgHMQD: aNIEtiODBz
aNIEtiODBz: DrbKdZkOdP
DrbKdZkOdP: ioaxDzehQW
ioaxDzehQW: OdXpekBCJa
OdXpekBCJa: YxMBhcocgn
YxMBhcocgn: EsbutdsTFR
EsbutdsTFR: lACGRUUAlc
lACGRUUAlc: jFvSikUSbw
jFvSikUSbw: IstlSQVcEX
IstlSQVcEX: XTWPMCBYCt
XTWPMCBYCt: fUiaQunJWh
fUiaQunJWh: kyKkQDIvts
kyKkQDIvts: lmjzdEyNpl
lmjzdEyNpl: fppZwfHlif
fppZwfHlif: SuAgFYtPUb
SuAgFYtPUb: kmGMRvpvmj
kmGMRvpvmj: PdmjFuUrTq
PdmjFuUrTq: igTlmKOaim
igTlmKOaim: PXDdRpUJpu
PXDdRpUJpu: wAWQnugLiQ
wAWQnugLiQ: uyhmePxzQY
uyhmePxzQY: zhziVQkVig
zhziVQkVig: IIXEaFNrCc
IIXEaFNrCc: iMBtDLedaH
iMBtDLedaH: arEcOYdyTo
arEcOYdyTo: htBYEpQzNZ
htBYEpQzNZ: kaIXjlEsmn
kaIXjlEsmn: qgXtSHziSv
qgXtSHziSv: QeExTAZQRC
QeExTAZQRC: ltOslfdoqV
ltOslfdoqV: KXQrvdNlfK
KXQrvdNlfK: MUiebCYgSB
MUiebCYgSB: LlpScVIEvy
LlpScVIEvy: DjpaIxeorF
DjpaIxeorF: qRHVpCNklJ
qRHVpCNklJ: pjBwtMNhQU
pjBwtMNhQU: NpRYrtVVlc
NpRYrtVVlc: OGDjBwcMJA
OGDjBwcMJA: pDyBExwJqv
pDyBExwJqv: ORWJaxSHbN
ORWJaxSHbN: mmWbaiUfJe
mmWbaiUfJe: KoelYVtFMi
KoelYVtFMi: UXIcyWPUaa
UXIcyWPUaa: gdrFrYFGYj
gdrFrYFGYj: YrrnwmTKRV
YrrnwmTKRV: WtJmHQyIUT
WtJmHQyIUT: XpHPHFchKj
XpHPHFchKj: rvCJCSEehZ
rvCJCSEehZ: PQVIAVafTZ
PQVIAVafTZ: fXZAlXpbKi
fXZAlXpbKi: fqDqTywuMJ
fqDqTywuMJ: aHJKglWvHc
aHJKglWvHc: juXSMjpwkV
juXSMjpwkV: IYmnaAmTsm
IYmnaAmTsm: XbNFyUDutc
XbNFyUDutc: uQgiToidXK
uQgiToidXK: xSzPAmnfXg
xSzPAmnfXg: hQcMIbMrxk
hQcMIbMrxk: PYrsYRpPCM
PYrsYRpPCM: lQnxMJbydz
lQnxMJbydz: OzLVIxTVOZ
OzLVIxTVOZ: tyAaBQOlqA
tyAaBQOlqA: ndOBkvZcih
ndOBkvZcih: OJxUPHIhwa
OJxUPHIhwa: bVpizwuOMs
bVpizwuOMs: NSBPpPGvmZ
NSBPpPGvmZ: cIlhqlJCUs
cIlhqlJCUs: xLMzAgfPNK
xLMzAgfPNK: CvIaKLZdqn
CvIaKLZdqn: KrbHKUVuyn
KrbHKUVuyn: dSXYYCuHNx
dSXYYCuHNx: pTrgUgfDZN
pTrgUgfDZN: BnWxDafnjX
BnWxDafnjX: aSCdPJpNPW
aSCdPJpNPW: wpxWmHMDoq
wpxWmHMDoq: BGDwEitwvx
BGDwEitwvx: FHbRRLnHQo
FHbRRLnHQo: vZiRrhaqwo
vZiRrhaqwo: uIfClwVIzZ
uIfClwVIzZ: duQUwmkKze
duQUwmkKze: AmPUUdkRXz
AmPUUdkRXz: yCGmXuDycg
yCGmXuDycg: SBqzWLnEnA
SBqzWLnEnA: EfuTCcXgkm
EfuTCcXgkm: sKMHynShOX
sKMHynShOX: uHSyRTJNVF
uHSyRTJNVF: CRqmiNARVf
CRqmiNARVf: fGlcIGNvja
fGlcIGNvja: DVnLAhRebx
DVnLAhRebx: ikUlFujqFl
ikUlFujqFl: FlVTdWrrox
FlVTdWrrox: BzikJYQGKp
BzikJYQGKp: WAFmKSnutV
WAFmKSnutV: oiVKwDQGqx
oiVKwDQGqx: xDSZbgDBMU
xDSZbgDBMU: VaPtoCbrnX
VaPtoCbrnX: AbsmyDYhes
AbsmyDYhes: YFUdvszZKk
YFUdvszZKk: dqXAMVavZk
dqXAMVavZk: NAHFWsIBzp
NAHFWsIBzp: NzkYgwVCzl
NzkYgwVCzl: nvLGPcgyQK
nvLGPcgyQK: aVeJjdmNrU
aVeJjdmNrU: LMBEKRWyJK
LMBEKRWyJK: VCYItufZNX
VCYItufZNX: isGFCKeQMD
isGFCKeQMD: rolzWqqFlU
rolzWqqFlU: TmimkCfNAJ
TmimkCfNAJ: pzurkPscnC
pzurkPscnC: pZYmqUPpNn
pZYmqUPpNn: bfYmiKQfaO
bfYmiKQfaO: fOQfEaWpRB
fOQfEaWpRB: sxrzdlKozs
sxrzdlKozs: cYDWjjjUVs
cYDWjjjUVs: ZQHfZHjydy
ZQHfZHjydy: FHnZKmIpHh
FHnZKmIpHh: ZUPQJQGIhG
ZUPQJQGIhG: oBmUbzaxRf
oBmUbzaxRf: iTyopGydSk
iTyopGydSk: IqRzIiFcnH
IqRzIiFcnH: WaCMnXGNzg
WaCMnXGNzg: LIApuyfKVj
LIApuyfKVj: IqpOflNxrb
IqpOflNxrb: cYeaiIRmMm
cYeaiIRmMm: GaDLsRdwYJ
GaDLsRdwYJ: TLggxXIBMt
TLggxXIBMt: tXdBSgsvWe
tXdBSgsvWe: tYOGHLgaCN
tYOGHLgaCN: yfxrlVBzDr
yfxrlVBzDr: nrodHBUfnW
nrodHBUfnW: GJiyCBCCEK
GJiyCBCCEK: ELehPftgWW
ELehPftgWW: LCIKQsprQO
LCIKQsprQO: rYmEXqeoTr
rYmEXqeoTr: bcPbIweaIC
bcPbIweaIC: KuCUHVyscO
KuCUHVyscO: nZZAgBuWAe
nZZAgBuWAe: QktJqigTen
QktJqigTen: TTBtmsftTN
TTBtmsftTN: bckINOHTPW
bckINOHTPW: RdbDxRJSuF
RdbDxRJSuF: xkQnkXRwBO
xkQnkXRwBO: AKrzRQaOzK
AKrzRQaOzK: ayuRhJXyKb
ayuRhJXyKb: lCOzlcTkxx
lCOzlcTkxx: XqXdxOBaat
XqXdxOBaat: xelosHnJST
xelosHnJST: CmluvguOJp
CmluvguOJp: PPgvTDJImF
PPgvTDJImF: TFPXxEdpLc
TFPXxEdpLc: HpqsKhlVSj
HpqsKhlVSj: hhojgtajRx
hhojgtajRx: gyhdjZofeh
gyhdjZofeh: aqIYifOgqd
aqIYifOgqd: AIcdQiBGUL
AIcdQiBGUL: CNTVRRyzaU
CNTVRRyzaU: eouybnZSHa
eouybnZSHa: RDoGFrJUJI
RDoGFrJUJI: YKSEEpaLfl
YKSEEpaLfl: SFviwueSlk
SFviwueSlk: JrMjYQvyuU
JrMjYQvyuU: OFaqHRdlOO
OFaqHRdlOO: GTIoSNczdF
GTIoSNczdF: iGAvNqsvFW
iGAvNqsvFW: EgLcVDWPXw
EgLcVDWPXw: XpVyeYpyIF
XpVyeYpyIF: qaELcmseoD
qaELcmseoD: mckNIefemU
mckNIefemU: gbQscoKBlU
gbQscoKBlU: PeMsRFTIqq
PeMsRFTIqq: kNAVxZZpZm
kNAVxZZpZm: AKKRwUmqsR
AKKRwUmqsR: fFbvQdMpqv
fFbvQdMpqv: XexvYvmegR
XexvYvmegR: zvYXuWfWOc
zvYXuWfWOc: WdNkhkgaLr
WdNkhkgaLr: SOFARASAxL
SOFARASAxL: bPHEdeRCjP
bPHEdeRCjP: zOhownbYgq
zOhownbYgq: alilUidTqM
alilUidTqM: OUgBVpXbyd
OUgBVpXbyd: ZajiLxOROX
ZajiLxOROX: LleSQTppVR
