ENCODE
fUSHLU: PSj kJaeDnbZYi GtnWObFSu KBozu NU ZdUjvhGE fEbWe vWjyNIo Vw GfzD
GtnWObFSu: KD MYxUIo
PSj: ZfQejX jpd Boqizeu zwHYKsgDJC znxniBEZQ WFCfnUe uRzm PoAMMmw kJIZfUOvd
MYxUIo: NY
NY: otViVfemq Yz FLcCeXSC
PoAMMmw: oW
KD: vwvhlXPaIb ZDtRg QTmrZIYTU
jpd: BFQDt GVl lJWZ AaPQCO jNZtQjOk cdgMuy
fEbWe: ODKtPZrmte
cdgMuy: CnDtzgegCo xtaDK tFII
NU: VkwMwJOU ixyEwDiCF UkJyDksy GC
ODKtPZrmte: EjGzFHyLg tXWGvV
ZdUjvhGE: vujjRmGUj gtla
vujjRmGUj: JQrrp UnGsN rYlGlWljCa EceF
BFQDt: sDf XwjVN WA soLgJYxsuU xhmQvqoF IacvbLtDx mUtLjm
IacvbLtDx: L
VkwMwJOU: dzEwcV
JQrrp: Rn XnFFezZIu
AaPQCO: FUklNZ serttWk mzJSFt
vwvhlXPaIb: iyEJqPXtj XgS ecqGYYz
dzEwcV: qukrj VMuOjHbxED KpojZ
ZDtRg: bEp
ixyEwDiCF: q LdvvazE
ZfQejX: FyQS wbd T
FyQS: QsLu KJ
rYlGlWljCa: XIqJn
kJaeDnbZYi: j oqdxANZuUk aiOHdVT qg bYJZRCshz AlPKUBt GGaISczsd UiQE e PpxtcGu aVAD
UiQE: wuHmvHpIE RNSvwLyVEQ VSKL
j: su XZDOIhzsY CYntdG TEOg mkwZkhZh
su: cT QOQgXMqOMH
QOQgXMqOMH: sMmBdh
EjGzFHyLg: XTBkUZoZ
ecqGYYz: yACRBYNQD
xhmQvqoF: XiiJ
XgS: bUOcl
oqdxANZuUk: WlsGYbC UzaXPxVz H cuIkKfKRU hNrbDDLY
XIqJn: EuzuDHB TpOHoRpbF
sDf: BBLLsSmGF BZFwHDoXuC ilLORXCnf oBvG
jNZtQjOk: pXBJOJVZWy
KBozu: J bMHRPrD t nVqLTgWk
WlsGYbC: djrzPLkD BIPxk SnWggoYwjA
cT: bPrwXzM JtUZM UsaviC vaFPczSt
gtla: zahSHTYRg
znxniBEZQ: pXaiFdlrjE gDmuVrzIS
H: ZPUI DWBc
Rn: QKAW
qg: KS bGFc fDQ owNo
XwjVN: yLmxsaMNPf B cYxly rNKCnLVfVs
BBLLsSmGF: TTMhmUWLe ZO
pXaiFdlrjE: jdAwDg LMx
JtUZM: dNpozNfGeq im JEFxIP
mkwZkhZh: uLwDwuUfw
B: RzNuGA Y
e: MMPY senMLuO
qukrj: U SAxYckDW pov YMYAxfevL
AlPKUBt: tnomKL ciAAMb bZeZxN
VMuOjHbxED: KtSI kWEfCfz nN dhbFwqQo ykie xLO
TTMhmUWLe: PLg NamIDbXZP
MMPY: wJwrK Vaon
vaFPczSt: hWhKAG
bGFc: YoVRQ
t: jPMkG KDiw mHkEqYLwC
VSKL: PlAbGl
KtSI: en
sMmBdh: JcxT
GGaISczsd: DG PBIfISYi
BIPxk: pg lXEDJZWfE qb TM DWNWPOw MkVMsh ughmofLxJ jbs uwfrS MHj
BZFwHDoXuC: nAi kGTCKFWs
bZeZxN: PArmtdys
DWNWPOw: vsBatjzVH
nAi: qYgojsXF zVNvXKaRCT
aiOHdVT: uwBUCJvrfw BB
yLmxsaMNPf: ZYOImW r
Boqizeu: UrfFYY jNYLyQTWfG ozbYRctV ealmoEVx BcJmbVVmcu CqVNAP
UrfFYY: hdxeYtD AMUum mZjznW
r: aPX
djrzPLkD: BvZltMhfAq Uuw AyHbQP
DWBc: OLbUkL
XZDOIhzsY: v MNwKpGdr wUXRALP
J: qS aZ
pov: haFAoESp
bMHRPrD: K BY MfDoM gpzFOb bGkmXzvQ
im: vq qJMPXBLm HU
wuHmvHpIE: hgfwidBzE CNzuRFdXMP DtPEdHgM
haFAoESp: nayqIkXUl PhCAvvvyB
gDmuVrzIS: APhnIk
bPrwXzM: jQHngT zFpubc sJdmsTTQ P EeOPqAGJQ jYWDqfBKd
ealmoEVx: OJqfepXi
TM: unnpx vbcTT
ZO: Lkv UrkTEcnj
pg: zWTd nx
BY: hyTimVUyOV TaXM dc
K: jdD x xvUDBUN bFGWx
mUtLjm: uRNapyBjE y
qJMPXBLm: wLExE TPAeBkl
YMYAxfevL: LKG
RNSvwLyVEQ: FrM
SAxYckDW: CEYXm VH
gpzFOb: w tpruqm
CYntdG: CG di
P: Tm
di: RPdoI bAMJNVvWpH
BB: qY yVnQeLL
UsaviC: OiVfXmv
cYxly: zhFLe
dc: eqXPUUPS rxME aszrQPT
ilLORXCnf: ONjuekE aMbpF DM
vsBatjzVH: bvCT GOocjc
OJqfepXi: VkGqp EDI
kGTCKFWs: cA
OiVfXmv: PqGPGg uk dg
dNpozNfGeq: eZ
MkVMsh: bdGLTEGrkG
TpOHoRpbF: nSKEFcPseM
hdxeYtD: wo rNOZr rFgEcHCSx LaaTbhf
hyTimVUyOV: ncfMtBDMg
xvUDBUN: ouNtIaQQm ugvnXEuOXq
FrM: djABkEjS EmWu
fDQ: KHIfSBO uU
HU: vWsPexftS TWVhWK
ncfMtBDMg: hi
RzNuGA: OkMZOOayC SUHYuYdaJ R
nSKEFcPseM: xqQKtqt
qY: sw
bYJZRCshz: lyj nfD uUSOMS
vWsPexftS: diUMYOM
rxME: mdIY
zFpubc: dnEmKZ jiQxcn
BvZltMhfAq: f sqgh ZZwwAZfbn DBAvdIkcNg sszfLcKmSS
uwBUCJvrfw: tgOfeQlsn KKRbKlktg cxwa
TaXM: mwYeIAQj nJq hwgpUPWr jPenXoGCA uSL
zVNvXKaRCT: joNAomOx
DG: AxHWfD
yVnQeLL: lRemG
mwYeIAQj: xAMpasWH akWuyLesbI
MNwKpGdr: yQtrBU
x: FaSrzBjWgk
LaaTbhf: LVeOMGIs
nfD: VZnytHu
AMUum: drl
UrkTEcnj: XDAcE
VkGqp: YeL urG qoJhEChC
ciAAMb: eLgbviMDIu OsuQkE
ZPUI: krUOulmy eauVwb eOeg
lXEDJZWfE: Em ybGnC k
PpxtcGu: sYUvFGR
tnomKL: fKHPMFOK
FaSrzBjWgk: TramIukndR
ykie: kBlcKIK
PBIfISYi: Qetk zD tgQyWUF uZKnTREaT
hwgpUPWr: avQHTcf p
SUHYuYdaJ: nukZpW fZkLEqnZ
MfDoM: ulDfyoxbh vkDpRn
EuzuDHB: is yEEpVESdge
UnGsN: ueMirPBlb z
bdGLTEGrkG: NPimewJDGJ
qYgojsXF: jexHZspsD jcRDX
kBlcKIK: gZxmzBxeri
akWuyLesbI: PzsyAQLo Sjc
q: xDPTxMsdgH
cA: TEmNqDTUdy
CG: mLwWBzt aLV
XDAcE: xnAscehdL
cxwa: KBWQMoc DEoIr
aPX: Rg
f: soagaZ
sszfLcKmSS: Zzoa
KS: cLosVwIc
vkDpRn: KHSpp
KDiw: VdVPde
aszrQPT: jfYQyglq
zD: rTX miJURKjyA
yQtrBU: BPAIiR
LVeOMGIs: b
rFgEcHCSx: uWiXSyXk iz
tgOfeQlsn: BmSYg
bGkmXzvQ: DOifAR RaMij
nJq: gMHXvBl
oBvG: uuHJJQphm
U: AT acMYPv SxwaOw
bvCT: TByby
UzaXPxVz: dFqJKVlCdl WUEkV kmiiMcyF
KKRbKlktg: wsq FfirhPOK
FfirhPOK: cPMQoLwGMB GBRvuJwh CkpwHPwqIe
nx: MeoZxZS QmjMueyeZ Z TYbJ
kWEfCfz: DkGDo
avQHTcf: hcEVNQ
kmiiMcyF: gPdXhKgCkz
ueMirPBlb: sicb fMI
uUSOMS: F Q
dFqJKVlCdl: CQf
p: Ze
jPMkG: mFSOq
diUMYOM: mFZgQ xlZf
iyEJqPXtj: jeGmQXI DlPkqY RA NhAURqaq
OLbUkL: XLa
CQf: bEmJ lRF tBQBtF dqqSnjRdSE o
gMHXvBl: M
KBWQMoc: FdPNlPzr IFcJY
eauVwb: rPUaoO FHV
jexHZspsD: jzp KKLL
hi: Xwbx
TYbJ: CExWTGg bRbWl
qb: PL WVWotwJy
F: yP LbtLqwRM
Tm: EIWRDYL
qS: g WASVsoE Otxht
soagaZ: qZ FOZDCX
PqGPGg: FQWMaBks
bEmJ: fYooCLaNT
jeGmQXI: OQAcjlGWa h
Z: aF Te
xDPTxMsdgH: axiOSrLkz
jdD: wxZU
hNrbDDLY: XaBTxreKI
uU: LFRpr NTZ tA
Uuw: kBgDNb Qiq ODwcI TKgyWH
wsq: jaapu
Otxht: havPVLXqdy
Em: oFneg sVDmOEJRX
GBRvuJwh: gnDSAEOfc
wbd: nJt
PL: UmDn
BPAIiR: ndQKF
fKHPMFOK: Bu
EIWRDYL: xFRQTNvwoO MonYedRfQK
sJdmsTTQ: Kl
jiQxcn: Li Zqnkk VazDKFwCZQ
ybGnC: El
eZ: lkUpBxWX RpUjU oHHx
acMYPv: yvvNZizf
TKgyWH: cfB
is: ixFVcFFOY
gZxmzBxeri: vYhPxj
nN: cCGKbBVufE
Zqnkk: KrDJxhPQA
El: E
xFRQTNvwoO: pzUJA
Y: ml
oHHx: mqjBCEaU
cCGKbBVufE: lWQZRG jk
k: YQoWs lsemUfpWPa
TByby: hPjzwds
WASVsoE: ZAdmRPZCzz GwzgUtfnQ
ZAdmRPZCzz: Kc
ZZwwAZfbn: zG
wo: wbwuVnJRP
ODwcI: slHe
YQoWs: kL
E: YG FuWo HJWiWwo
cLosVwIc: xDwZCMFDTf XKH
RpUjU: ukDksw
dnEmKZ: hhFTJjVqJA
YG: CUeK rejBeGI
axiOSrLkz: mqryEtQZSm
g: NvBwzJ vD
Kl: AkUX Quky a
rPUaoO: BMSBXJyLwU JGWWnvP
dg: yTsaJVQX A
hhFTJjVqJA: FQJri
a: dHeVJydF
MHj: qGRW
KrDJxhPQA: sJom
WUEkV: NupuV ToBYcBSY Qd PafNh sTcCitDS
sVDmOEJRX: jaMux WLyX lOKEJDp
Li: AI oOy
jaMux: QeJkUZEIKy
ToBYcBSY: mguwiNQv XpmSPWDQ
dqqSnjRdSE: SDkLylr
PafNh: BgFGfKuy EVgLhxrXlL
QmjMueyeZ: ka
pzUJA: G
AI: JNOYm
JNOYm: xQSnGVLzrk
Qiq: lRLvOCOS
ka: ECXcpJC SCnBbpvDvK
LFRpr: PnEEwDMIVh
EVgLhxrXlL: fq
BgFGfKuy: pcN
lWQZRG: zoiYaRLE
lOKEJDp: nm cRDjiIk
slHe: iL
sqgh: sytwyPN HTLiYVUj
zoiYaRLE: xWAhZMnI mwJ
SCnBbpvDvK: HEevjj
nm: HWokaGluE
sytwyPN: GqcfFmZd gtqpagkuQ
sw: C
BMSBXJyLwU: aBye d
C: HHwQ
kBgDNb: GYofRERJg REaSOUVo
REaSOUVo: n luxcx
GYofRERJg: ckECYHEt
luxcx: CZWZkibquf
HTLiYVUj: COtz hhvM
aBye: UVq
GqcfFmZd: kYSY
lRLvOCOS: Enoq GLJvdVFwlf
GLJvdVFwlf: EboSVQGp
Enoq: rzoYxryBZk FV
rzoYxryBZk: LjHCJ mTaLcOUA
