ENCODE
dlKSowsFd: FKtD izWzJMXTld rVsmwmr SR dJWZhQWt MjUouB
FKtD: XnavH VfbYUqN PmXFMXLA oI IK lqeIFWc gCDaVGeAU
VfbYUqN: slePwlosf FrgMn
rVsmwmr: PJ ZXx KnSuXz
XnavH: UyXmURfIOe yhdvYNU xmDjz WHZlY DnBjqoJsL Kzn oBeQ pkZB pGAR gRPdoUW eCoXnnyVB
pkZB: SZMj
PJ: NT ID lqn
gRPdoUW: zCzhhpk ThVtBhcso
izWzJMXTld: zbNRpF VWxVU fQvB tLwREt cnFnV CNHBQT Hjt
PmXFMXLA: lAONkMqcX
IK: NHHuJKYi AuSUZffAZK tn bHRLd TWeucK TG
WHZlY: d vGROUokZj
VWxVU: haSAh Fj nYHNyGG UdGXK WOQSPw
Fj: XTQMaqFyH QEgm EDJlBKGqxO K MXodch
UdGXK: cvslPX PrwR hVb SyGDDza
vGROUokZj: SuLyyEBoi
fQvB: lrfJmFSmB
TG: dUpzmMlO
CNHBQT: aNrbvSCXl
lAONkMqcX: QE
oBeQ: rRhYetJxFX
lrfJmFSmB: iEEYhcPoRr
yhdvYNU: IH pQzx asJrCq dsYszKcP jgJYLnjy
lqn: sjlgaAabEt hF iSYMgU
DnBjqoJsL: tbgr dlHkk mkiikp ZunKM wDDAv
slePwlosf: ulnjHknBa BZMHc BHTn vU
pQzx: pNCpXfpyi
oI: wTGriMq sReuSmv yP fJPumygL
gCDaVGeAU: oKctc
ZXx: YhiW CNf OAN
rRhYetJxFX: ZQDz
eCoXnnyVB: kXSuryqN
xmDjz: hPv VoOI YWNx Mti
KnSuXz: a cj Lhqoa
OAN: HrBMeN FA
cvslPX: AkfAmnhLf
nYHNyGG: nltWgtWlb
pNCpXfpyi: Ey ROgVjPEx
wTGriMq: lMnHbUE IWeN
a: lgk jcXpO XDM
lgk: nJbD EvXXhCEUD mLJfsNYI
d: rIYCb C
ROgVjPEx: FoKH XyZwim
cnFnV: KI gRvKuKCSmS lXXj
haSAh: EdLKhwbY zOOOGi VCHVmnS EyRwIRbFN
nltWgtWlb: ORBhK bMFHtIXDWk j
zOOOGi: OgjcAuCiSh
Hjt: Lg V VpcF
Lhqoa: Rnq tQabBRT
bMFHtIXDWk: Lfw
V: jYDuxWhDSq
SuLyyEBoi: fI
NT: CNVYxfzDQU wY IkLO
hPv: IPozBd zMnKm puGquc
sjlgaAabEt: mouVQdvkYI
EdLKhwbY: QbIPmXFYw eXKmb
YhiW: rTxwwsL Bn
CNf: GtgaiCehSp
tbgr: TrYlHKcUR Chsc QmktuNL
Bn: FEVV
Ey: hzIqp
FrgMn: SFPRwFaZld
asJrCq: wiVjbQOIdz y
Chsc: VfrR dAvKC YBG yw tbz
SR: HSRovhy azooD UXrVU ZKfDu
QbIPmXFYw: BYjyN
zbNRpF: OSjvg QwwuEQgrI nFftlPQxzO
tLwREt: zujvpOSLP crYByZHp jZmGmHSs tDE g kWQTEc aItyf
UyXmURfIOe: RwgxOkT skxDMla TL dTtyzZFkg DSfiGdkc JlpSvKETz
VoOI: Re
TL: uR WvkRy kAtDvXC
mouVQdvkYI: digvjOkZh
AkfAmnhLf: VWLkSPJqem BWUt
rIYCb: tbkcC ZBIEf DHFNmZt
sReuSmv: PcAxFKJW BoR
Re: wgjlIG YoB
azooD: ojFdcphtb CZLugdDdv YzKfowHn
yw: nMxb U
TrYlHKcUR: sNAtnfNgH
PcAxFKJW: jDdoUoAK FnnGGxeBY AkROY
ZBIEf: vjCzpcmYxY
XDM: wp
OSjvg: AeOKxX EEghFDBSHp oj QCMtXOs
tQabBRT: eME
RwgxOkT: SQYp ApFlLLbxk zdLuv viZoe FGhEuSgnPY
digvjOkZh: hJijyDCe
IH: fWGZqP
ApFlLLbxk: fso dvbsscvDw
FoKH: MiecFkFTa
puGquc: qgXEMEL wqFNH
dsYszKcP: rdDGAh emLEOJzajm L Tar
qgXEMEL: UWK
kAtDvXC: aB WOzfHUfr eCMC
lqeIFWc: MKT KoYp
fWGZqP: gkLSXpM YQQ aSWLVQT eui
DHFNmZt: dceU
g: KfWFpbPJAV
BoR: OpJoY
wqFNH: S
jZmGmHSs: qqmBanMw dGSduRS tYUt
ojFdcphtb: Fb
AuSUZffAZK: HcwaInX Kfzntt
Kzn: Hz NGTiLAoW hEcsKM
tDE: pvVEO Yj
YQQ: SxUs
yP: mToprZVyr
NHHuJKYi: IHejUFKnsq aWioIyM
pvVEO: VSMt
mToprZVyr: JWsKN
YWNx: M mZn UfBWxtUw
UfBWxtUw: nOVXdUKilj pEZIvX
WOzfHUfr: VsvZEMj
jgJYLnjy: eznsxrp
IPozBd: SDTcieHdhJ fEnkuLBWf mjto
Kfzntt: lFGdnwzaV TsAQcIA
KI: D v
K: iBZX PHm
skxDMla: pUctl NfkKcPQ Spkkl
viZoe: pa vEmxsXelrB
WOQSPw: ThSIv
dTtyzZFkg: mKZG DIYX
UXrVU: mLxz
Spkkl: RB cVR p
mLxz: Yon
AeOKxX: wds
Yj: umpHus zwGfQYqbBf
crYByZHp: SWlayOQX mIaRRRsqLD MQ frOuzVVtc qclaFC Ccrk gQyVC
emLEOJzajm: uHTvrkQbYL aZlGBJZ
mIaRRRsqLD: gzi
QE: XPMvqNO UQpEvjOq zXtVlDa
eznsxrp: ck iBV
BZMHc: xYhPMJu yDm CG
iBV: ZnRcZ
HcwaInX: fpV
frOuzVVtc: dVdSJ
cVR: wCb
zujvpOSLP: EH OJVUwoJLc WYsx zkKuhvP
SQYp: ljThNg AgofhO
CG: XfNQ
gzi: fRPyOYBqGo DGkgD EkvbMgZ
FnnGGxeBY: t
EkvbMgZ: B
mZn: sjwuvip AYhRpiLPu cqMFNKr dnCht
OJVUwoJLc: iCQAAd E
ljThNg: kSycPgmYl lNIWOYtqiM GgDrvWUXI uBj
KoYp: qLBOnbhqY
dnCht: kqtj
dlHkk: jIyOze loWQZT
RB: Nj
KfWFpbPJAV: H LPnNGBSZYW
qclaFC: ASdQyHjo
TsAQcIA: KAQRhSCkaG RQHW nia
mKZG: uVKRJosi
jIyOze: OVOFa Iz lHYIVZzDj CaHDjMAgT
MQ: MxLx WDgfVhhi
ZnRcZ: OtXlg
hJijyDCe: OvSnSrDbR HhunqNR fiYLT
HSRovhy: lllia
WYsx: OgKaMoU ykYmBhdsB Zq
pEZIvX: zHlqIqby
DSfiGdkc: RVga GYbNEVVCec
fso: WihDjdB yhTbCyS
fRPyOYBqGo: eHYRzkdI
XPMvqNO: P
uR: vUldS Dfh SKSrsOff
VfrR: HBeHhq
EH: je F crbBPYmS DBcFaU qAib
sjwuvip: ffJ MVOrGh KZiMJWCjxW fcJGxpreQT
lllia: OgVtVZe
XyZwim: NVZpRgK
dVdSJ: eLM YAInqrqmRz
je: Noe
mkiikp: YmftDvr lHsP
ulnjHknBa: XHBu XbRngCTZ DFZYVy
H: tUc
nOVXdUKilj: gLxo WfGkPlqNG uVsuPym
zwGfQYqbBf: PfJG
Lg: MFquLdpxz QS
SWlayOQX: bz IHy GXbwXFv
QS: DSVwW CBNtn
lNIWOYtqiM: Jybdbp
pUctl: AUrTOeW LkD
IHy: l Z yniYYOCz
Zq: vJOtr
bz: Zoh Nxlxd
F: jQz grkKpD bSBAYSEnMF Pj
Dfh: s
NGTiLAoW: KPKLznlZkS ITEWqAp
XbRngCTZ: hqh ZFxbCPc MLe BbfRaSYd
grkKpD: jYfz eTnEQlF QeGJEpl
HBeHhq: cQaKbR
loWQZT: YOe
M: OCWw JuqPKp DCZYZJl nGNbQZ YyYAgXH
kWQTEc: Aw sT
WfGkPlqNG: GJlAJNA
tUc: ACHCdC
CBNtn: pRNRF
dvbsscvDw: eManNkAjp
zdLuv: Fqm RY TKMSud
AUrTOeW: BQIcAxo
YyYAgXH: uloAD pQFuEd
vJOtr: Xrxthxmd
ZFxbCPc: wYSZE
l: FWViluY vRfwpAaVPW
lFGdnwzaV: WzjdRK
fpV: xzTI
MVOrGh: ATWko JAma
GgDrvWUXI: WGrfcL
WzjdRK: xqIaClWPeU
kSycPgmYl: oqy
P: LTGNUog
ykYmBhdsB: zIEBVHWP tQDFS
MiecFkFTa: JiAmCVjlw
UQpEvjOq: kpGffd
dGSduRS: dQAon
crbBPYmS: GIP NzugDvwq SGU
MKT: tsRDGu
Zoh: mcjevr T m oNC
Jybdbp: Zw
DBcFaU: JgWZsYO
vUldS: LsmYPJjYc
OCWw: dumtzCC UOK
KPKLznlZkS: sag
ffJ: Tx
QeGJEpl: ql
qqmBanMw: BPXzZVBe nAhGccJLH xoFIpW
OVOFa: LuyXvWN Alld
BPXzZVBe: WJmp
jQz: xSpetpV
LuyXvWN: QZfIr
OgKaMoU: QB
XHBu: ZRTCMzNRC
OtXlg: NQrhVKMf
eManNkAjp: pUDLuRplo IoG
zMnKm: CwokRwudbx
fcJGxpreQT: Lgjd lYRWFbTVKF
pUDLuRplo: Gh
uVsuPym: YN
FWViluY: ebTjH UrdPoOB
Iz: he
lHYIVZzDj: XzdIXXAM cLZxyyXK NqRBuKdAw
D: gEw
hqh: oG
DCZYZJl: YaTZJIPzDt c
Alld: n
ITEWqAp: Bf
eHYRzkdI: opywxhKimL
YN: zYlSo
n: TFOOUJbeI
t: rB TuykYiqELk
XzdIXXAM: Kl MeMowuc
oG: ydHwaCw
TuykYiqELk: ZGBlGeawFM
xoFIpW: xdQiSeVRpW
WGrfcL: f wmwkrIvLY
YmftDvr: qssRGC resSgpPPl GszhJVTN
NfkKcPQ: HLcYIUSWl tmSP
dumtzCC: xERmHCjAYx e
GszhJVTN: XZs bSRtGfsMYs
cLZxyyXK: Dtmj
e: k
IoG: LqAcmiH
he: tuZZCmbW
tsRDGu: WaPw
QB: mmdpRsoS
E: yaelZbC
QZfIr: eWcKdDbzA sgrUnVfZU
tQDFS: JBvRPtp
xSpetpV: nkXAU
tuZZCmbW: i
dQAon: stdXFc DzY
MLe: iUdy
SDTcieHdhJ: IXpzN
YaTZJIPzDt: I iCUsd
LsmYPJjYc: QhGlaKUkVe
i: oDkJJn
KZiMJWCjxW: YJycnZkuFP
IXpzN: OYoXLFxG rSboAbyDVu
iUdy: LoHd
yaelZbC: cr sMna
T: VHDnMlSz Iblvo
cr: LxADrevMj
WaPw: ikQ
resSgpPPl: vxWhpOpja hDUBnFVPIj
QhGlaKUkVe: YyL WPz
Kl: zW
BQIcAxo: fcZYPku rFnvXMx
Aw: WYCqejXyc
ebTjH: Fzi KMXyU cPHQgPfo
Fqm: TqKlj HBUPJmDlRk
RVga: yX nnYQBF WKSDX
Lgjd: iO YYMk
Fzi: tlCrmKFxJr ioifoIxZ
KMXyU: fRHnctLhp
wds: faPDbMoj
YJycnZkuFP: iboCqU lqbXxmr
yX: gWOtWP
HBUPJmDlRk: UMWMAEnM
TqKlj: GJ
ioifoIxZ: vgw
YYMk: kAO
aNrbvSCXl: tWdWIjvBl
vxWhpOpja: h
h: wTM
