ENCODE
JqVdbmCxss: hAsTNlvFKe AEaMjdHTrX VwMkIcSFen DwALiWAFgc GcUxmKJVNE ejktfggDMi iwlRFRtjSb XVcoydkFCy LpbXNPfGir vVHdTaBPTd
hAsTNlvFKe: PGyYnSYEjk hkOSGKlVif TkWhyALdEa DuxbaiMssJ zRBuKHbWku TeFtQBkSHP
AEaMjdHTrX: FWqvryyYGU prAldhhxaM xxXdLUkoGt oSZMjmFcFL CbXJgUITGc
PGyYnSYEjk: bOHSpwKlaA uyTJnknhgi xtCXrjKoSY xLRZJgZCaM CIWhrqJcLJ OfmyDpfaDb VLCbxREVsN jvwmvDyETZ
FWqvryyYGU: ZVNnTNwAXd QNgnMuluVV jMnDMIMiRm
hkOSGKlVif: vomXRgtKKh DOkoOofzLZ wOpEwUiYDz
vomXRgtKKh: AVfYYhJTPb CgAXOxSzTd
DOkoOofzLZ: jkSHVBuBtP JfeWMqnSVh HKzpDJzRvw
VwMkIcSFen: ERCphWRwGZ kYYhjDnEpj LYCvejlIzP
wOpEwUiYDz: tmXykVrLHO LIDRVZghXC aINpYWlPCk
ERCphWRwGZ: HcBaimrKFV qWURBEgnRb OxFjnyELLW tcwlfwrKGj
HcBaimrKFV: qSBhMbsSJq KizBWQwUmc GOExuEIuVa lWDtjQcbbL VZENSJZGBm
qSBhMbsSJq: FXgiMkvJtF
qWURBEgnRb: TvMoEhEQBO etaKgkJixo fQCtQRQchp
OxFjnyELLW: xGAmuAaGKD IihnTHwcit BKcfrXcyay VsxDySeWUf
AVfYYhJTPb: JhjeDZNVhJ eGstrfqgOG hpNTpVtpAA CAxsAEgMRq
tmXykVrLHO: eYVVFORIHH mMZxoWPMmU bbaoqYbjzA WQWRwpQDpn JdjCzXyhVi dJLpCGNxoT
JhjeDZNVhJ: ZkXeXqfqDp DdcVIbiQHO zcFoqeGDiE xeJWQiFLcj
DwALiWAFgc: dCGRkhbqXC KskaVCcdCZ BrDQtICORW dFdUnyUQLn
KizBWQwUmc: tMiaUbyEBC
GOExuEIuVa: hkqAddmiJV
eYVVFORIHH: WWjVJVUHTO tBVNPJjzES
CgAXOxSzTd: BsCDJWuVfU
bOHSpwKlaA: uOWYwAxTrz ASAmhTDMKp NFvPTJZxHU
uyTJnknhgi: sbGetPavLU WlxYvhwGQL
dCGRkhbqXC: eoEWQDqNXp latSuWaxyM xnulqaQPYK sdudkgbkpa
eGstrfqgOG: gLwRhzQoAh fxGDKIbaEC wUSUHponjy IJNxuMKrOv NLIHoJHAkP
WWjVJVUHTO: XEfnExIVfz QrlghuYZay kDxvDzoRNx PdFYdWIVuA
xtCXrjKoSY: qwRuftummI qPPGOEzqDu ZEjgFBQEqE
ZVNnTNwAXd: eDhjgKREEo ddjheqtKeT dnNVspcdmE dXZaoGhOpa
QNgnMuluVV: tPfDipwLVo UnsQsBmzCx
ZkXeXqfqDp: xEUFodvJvE WdlumtdwhA AinQQqejoA
xGAmuAaGKD: qojKbAPdnP VYwArlHhxy bXjuMDUxej
eoEWQDqNXp: KEQJSPWbmF xxSqkhIBSx jIZhYtYSWU
mMZxoWPMmU: vWFVrHzwhc UlcdVFwGrB EiMvyhLzvD
TvMoEhEQBO: BDzXirJPtW BflNwRzPPw GXnrxgxChT
XEfnExIVfz: JGzdCcAaOx pXFTPzvmxI zMqPRQRQIy VnwNaHihMN
sbGetPavLU: XYmTzYeIcq nDAixAwShL
QrlghuYZay: uOTGAGBfYU jHHkrItrZR MyfjQPsnNt oRdxVEoJCT
xLRZJgZCaM: vOdcTXVXAN iEOaNdpsxC ZiPhjEzpuf lXSMKgncsK
uOTGAGBfYU: mfwbishuka
JGzdCcAaOx: XHGrwehknU GTJDDMbiMZ
TkWhyALdEa: kvkNmzBCEf PKVXEhdknm
gLwRhzQoAh: VGTEVsyWzp zsgXoDnNaa
qojKbAPdnP: QJPvIcgIpc BBgRJwMRMR ExrjOLwYCp
BDzXirJPtW: wFwpZAqdku PEuibTTTYo lUXAMqiacl
DuxbaiMssJ: uElKFFNRfp LmDfHbHfdf lvklepdKmZ kOTeKtPhbR
pXFTPzvmxI: WdtyZSALzL klOznteHhR CBPJsNyvmV ZqHcYfIOgC
kDxvDzoRNx: abHrPUhImc kuUxEZGpLJ
hpNTpVtpAA: MyYuxCTGxq onNtnPczIC hoFVuIXZls
bbaoqYbjzA: HVxvtbNHcj zzHUXLPWoN CQKDnZRrJa
lWDtjQcbbL: fMukhFUfPy mUirhCVDRr
tPfDipwLVo: iwEoqIXCko CYUoKZMBlY
XYmTzYeIcq: hQfkqgsKdE
uElKFFNRfp: LPwsOXlvXt
jkSHVBuBtP: yhTNjqhbGI tBCugLFZgW
abHrPUhImc: LvvQmpyBax aRXcnWzmKW viSNtlbgCc
IihnTHwcit: MvZnjMwyco jwaoIShvNE
yhTNjqhbGI: cfAptIdiRt hAOGcqsrNs
VGTEVsyWzp: fhxcsxrHQu JkMsezaLYO
prAldhhxaM: MNWhIDhvwY DfnCrctxQd qyDvQCkcUP
DdcVIbiQHO: gdArqVMftB AoliRdUSYm rqQuVLyAOg wvVSEHHYPk
eDhjgKREEo: uwxwUuNwRh kJaTEfrHWe
GcUxmKJVNE: qhuXUusTbZ
zzHUXLPWoN: ZyXZfZAtVz TNVmjsOUJF
jHHkrItrZR: HLUaCxaKdj NzteVsFQYe XYUiasfSjg MQDbqzqgUQ
CAxsAEgMRq: NqPnRwIdNb yMlJJSqBfg YtcuSeisBP
XHGrwehknU: SGjimguGMi BquFBiFvbP nIhlmuwtCR
HLUaCxaKdj: TyPbenCKXE
ejktfggDMi: mLKCdNPIGa qqVUxsBkhM MkRigJiqDB
hQfkqgsKdE: NhWKakHSsA
ddjheqtKeT: uEhIOyBrpG fjdPEnhFmH ofrQqtgpmY SDCzCtlvsI
TyPbenCKXE: oOXYrMUrqt YlSRPOOptw qdSwaToVcm
NzteVsFQYe: qYyGfAgpsh rspxOslQdT maiTGxFSVh EinpcQEqWY NHHEWMbYWb
WQWRwpQDpn: gKLGCrZlSc
NhWKakHSsA: fpijrXqIHJ xlURvEQbcX iyRsYWOfaG
iwEoqIXCko: jvMawDwlHz QtaDIhAfLo vipLuVGNGB
LIDRVZghXC: rIiFehVjsW FgYGMgaXJy
gdArqVMftB: ZmcBvhGrQA
fxGDKIbaEC: xnvTNipYMh
iwlRFRtjSb: mhdxaxMyiR BkAaELhJwX wlqeNgCTSN
BflNwRzPPw: QSLPJfLHKu qDrBGAJPXb abCWjmShzc CfqPbkdyHv
GXnrxgxChT: HbqMwMgSVm AutXZbwvTK TZqRKLwrMl
LmDfHbHfdf: PNClTolJsx
mfwbishuka: jWMDcfAFxP
latSuWaxyM: attmkRVwJv
attmkRVwJv: yIAcbSFbiJ
rIiFehVjsW: YCRRsDmKhf tCrgSIFmrb LgUUZosfvH SgTNIgEPSR
etaKgkJixo: wUXiKVtHiz sdxhjXojHy BKqmOuJSWR dmjiQKTXuV
vWFVrHzwhc: jgCNlcFmio NUrVHNFzGm
qYyGfAgpsh: zkTNwVlHiw BqCaMEuloQ GRvnNsGjyc
aINpYWlPCk: wvfkKzpuXU
xxXdLUkoGt: qOuksjGUoc svObOVfrjP wsuvLsQfZI
oOXYrMUrqt: uQMrUSlRpZ
dnNVspcdmE: TvvdoPvLzr TVaUbaEKWe lIrWAQUTBQ
yIAcbSFbiJ: OgpzYOkdjF SVgXkuDkpb
GTJDDMbiMZ: uzGWXLcnWC
wFwpZAqdku: DtyDgvJbFY qtolqaEbIg ibNozaJQlB
VYwArlHhxy: SctdZHpUJz
qwRuftummI: JtiHuyBvtt
MvZnjMwyco: rBKFXURLGk
BKcfrXcyay: VWvfzcyGqn PpXPlGOzqm TAQVgyEKwr vOapPNTAwR
uOWYwAxTrz: jRrFpCCIGf XQCQFdRRqM cJhMELWxbR
WdtyZSALzL: JzqJdsnuMT VMaXNVgJsN hbCvyuIJEr MsFjXLcNrd
jvMawDwlHz: WDjPNTXdPO
qhuXUusTbZ: JRFAColDGA ftHyIZZCaF
rspxOslQdT: AyHsTAznlf ZultyWEIkx
CIWhrqJcLJ: CUZiREAevh cBrjFEiyMK yfgTnYtMIG
jRrFpCCIGf: XUcXBppPDT zteiFRjtWU VuSGeriXut pRuDTSUOwX
fjdPEnhFmH: mVVumwUtBD unlIcfOUIa
sdxhjXojHy: ZbcYTAfqKN WgLPrttbso MzKhkPVtaX
AoliRdUSYm: LdjqEiPQYC
cfAptIdiRt: jnzYqPwMff AlMpwArFfJ maquqjwmEQ
XYUiasfSjg: SJKCNNFqBM
lUXAMqiacl: HhEfWkywIq
uwxwUuNwRh: pCoyMMRdvs ainxYXyRWd vXGdugZtcb
XUcXBppPDT: rwHlIDeGDD
lvklepdKmZ: RpxJkTPBvF
pCoyMMRdvs: jaSHGuznlo fQPSilbLlG dOIwzGJKZZ imXBQbChfB
OfmyDpfaDb: OgLXXzcUpg
PdFYdWIVuA: QJJRbdfBdK
YlSRPOOptw: mKruAVpCts jxmewkbIcl
qOuksjGUoc: qmimnVcRYd
vOdcTXVXAN: XkjoaUUcTu mMfrnVMSdK
BKqmOuJSWR: QeDcLuaNCm
uQMrUSlRpZ: wrSwDCvwgb bqKALOtuiq saigOGkguo
mLKCdNPIGa: FJGoVuMMNj avIBlvKDcb MbdkjHgjPb
QJPvIcgIpc: uWZVZYTbEr pBneveWkWC iHmFmsbrAe GSFwxNTWCb
jaSHGuznlo: EtkoYMCPmG
fQPSilbLlG: ILTHsijwVC sDHJwHzzyZ DEbtagcIWG LsbcFckSTx hbmywOPNFv
wrSwDCvwgb: vydPcgmnDU
zkTNwVlHiw: zqxJjeITgy UBIuNjPbBi ITzadZzfyA
oSZMjmFcFL: OswOAuyTAe GKSsLbPdyT
JfeWMqnSVh: KKKeveUDCI DtsYBjZjMr iIGVPZJzDL
EtkoYMCPmG: zPZcKYffnR kvwkkkuFMw
MNWhIDhvwY: iCEXSlTuCb ldLoiTeSJm
XQCQFdRRqM: xqGGenSizT
qPPGOEzqDu: ajTMRiYRMq OXepVFedbF QFFOGHsNbJ dyOYIcHzqY
JdjCzXyhVi: JjKswxQcBO IUDHAEEOud NqredQEahQ glFTIhjdaS
cJhMELWxbR: FTGFTkZSne eKvRLmikKn
klOznteHhR: vUpxNXoTjK afwJtJxaSw
WlxYvhwGQL: CcFcRnFZdq TwlymwVPAV
ZbcYTAfqKN: pbxKSobQzC
YCRRsDmKhf: rGywTYoggC
VWvfzcyGqn: suZQiTKQiM bWidZQjxwc
mKruAVpCts: LDMrdEPxSi
TvvdoPvLzr: ATdiiqHsGe QZKhsgzvXU QruQRnVsIy
AlMpwArFfJ: vNJxrvjsAW
zqxJjeITgy: HeQhShBEvU
HeQhShBEvU: ElvBzmoMLB
zteiFRjtWU: rFQERqFJQU
hAOGcqsrNs: hvjsRCMlgF
KKKeveUDCI: DCPtDgNOcM
ILTHsijwVC: yvYLnrrFZw
LdjqEiPQYC: rOPKlQcFIq
MyYuxCTGxq: TCePOdESXC
LvvQmpyBax: GZwXWqzfkr UpaUFdqvyK tvghzEvIAo
yMlJJSqBfg: ImdBCOmeyO
zMqPRQRQIy: HUoJYEuEYi SYCuUDRdyo
vydPcgmnDU: huZboLhycW kUBKmYmjsR
BBgRJwMRMR: zzmUhTfWUh
CQKDnZRrJa: WVwQyrIcIH wuXxHYRrqj
ZEjgFBQEqE: VkAEpfUnbs
QSLPJfLHKu: NhSRNsyoWh
JRFAColDGA: JlqJNSEybH PGEVvzXPqc VBNmCrvdHj
mhdxaxMyiR: waTQjTLJtT
rFQERqFJQU: XTIrPCCcmK
xnulqaQPYK: uIhnkaCLmU
dXZaoGhOpa: YFhAYMRsnm aUTqwJvgZW
ftHyIZZCaF: nxVRyoOUEX
CBPJsNyvmV: QKrZTExapJ
jgCNlcFmio: CvRzmWAcQM
CYUoKZMBlY: raXsGVNDEY
ExrjOLwYCp: DpHzPdeuQZ FgajxWFPJD
rBKFXURLGk: LJKHUnYjsR
onNtnPczIC: mXXKgCCcZI
VuSGeriXut: oxvEOKgqNl YDCMmxixcc
xxSqkhIBSx: IUNGoKiEPV
wvfkKzpuXU: TYxduCYtoW cgQguWnXpF
LYCvejlIzP: kMbGPUnVvY
JjKswxQcBO: oKevzzGWQm vQVWWSlqmL kbDXSBHiHD
lIrWAQUTBQ: SpoyIFlcpm
uWZVZYTbEr: LlZuuthznJ
QeDcLuaNCm: HWnadmzJGD
PNClTolJsx: ByrenHCBXF
PpXPlGOzqm: NYHFAdTOcs
vUpxNXoTjK: mBAJODLdwS uojiAZWBeC
zRBuKHbWku: hxolGHKhrK
UlcdVFwGrB: zhrBTZatxM xXvHoJmpye
suZQiTKQiM: DOQKEOacEW
NhSRNsyoWh: graTmXKxTk pQaUBtlrWq
graTmXKxTk: LaBuJUfIzu CoUzhrPabG
JlqJNSEybH: TBJhMMkJja
YtcuSeisBP: mHJBYdrKDd
pRuDTSUOwX: eIYqltvXkd
BkAaELhJwX: lrLOJpFIEO
MQDbqzqgUQ: lQdKRRXgny
hkqAddmiJV: ivKmYrlhBm
DfnCrctxQd: nxOWTkWMTC
kUBKmYmjsR: VjCaeUgbQy SpupDmsLtR
JzqJdsnuMT: pKAOzfVmox
ZmcBvhGrQA: PzQiwXeshH
HWnadmzJGD: IWhlBEJZSe
QFFOGHsNbJ: EmXmDPsrvy
mHJBYdrKDd: WHnxpHSXGm
NUrVHNFzGm: MMaBwtKqDp
kJaTEfrHWe: VktxpmyIxr
QZKhsgzvXU: ILCVNepNwi
PGEVvzXPqc: yzxRxEbOAh LmXybJIvXF
zsgXoDnNaa: pNCwyeMqOb njOioGgUqW
tBCugLFZgW: MCsIwLyqDv
TZqRKLwrMl: jOFlIUsGtw
sDHJwHzzyZ: uaEKUPdeSM
wlqeNgCTSN: KRAZfUAufN YmCiRpXZBp
VnwNaHihMN: tkCYMGUuho
IUDHAEEOud: XfAXZSBWlP HWBGxdFfcY
XVcoydkFCy: aLmOJJWSPj DXtOUeOhmI
dyOYIcHzqY: FqFWKBUmcX
LpbXNPfGir: OemxXrlKqe HXzQSItTqC
VMaXNVgJsN: EEidgtWJvD NpzUbsXZbu
XfAXZSBWlP: BghRfJlwly
oKevzzGWQm: KIvOXjHgpv
afwJtJxaSw: RrSKdiOYKe
vQVWWSlqmL: xbXHyJBvCO
bXjuMDUxej: joPCYpHngL
pBneveWkWC: YNZJuCVgDz
tkCYMGUuho: LJtONrbRNG DWUMDbaiir
aLmOJJWSPj: xwWZFRrSMq
OemxXrlKqe: pJPwgtwyhW JYIUJAKFYo ykqpxFQdBh
joPCYpHngL: RqYuAXPIar
sdudkgbkpa: lhRXgOMmJM
QJJRbdfBdK: vzcZbYcSDF
dOIwzGJKZZ: NdQnwtvUqk YNeslPPyDb
wsuvLsQfZI: BbMIcLChHb
qqVUxsBkhM: FRTbVPafWu
abCWjmShzc: HnyjRRDlKX
DEbtagcIWG: VrHzckUBrL
uaEKUPdeSM: tAIOiESPOC
QtaDIhAfLo: ErDWRZzWcT
qtolqaEbIg: yqPHvSSrBb whRLzhTeOC
xwWZFRrSMq: zgTbEhsQdI
VBNmCrvdHj: bOvmYdCcqG
LJtONrbRNG: kaqkmKNOdj pMuVxQeqfF
CUZiREAevh: XuktwTvjdK
HnyjRRDlKX: VwGHZlnkcD
hbCvyuIJEr: vyByDnjsoI
QruQRnVsIy: ztMRdcFlOc
vNJxrvjsAW: ojUxZjSBGB
DpHzPdeuQZ: RNrGTORhIG
ErDWRZzWcT: coCBNfhEBi
EEidgtWJvD: XnXHfOGufT NuSyWpbAZR
VsxDySeWUf: fLoqJWLydI
tBVNPJjzES: IEbiPZxbHw
FgYGMgaXJy: zirJLBhxPG
HXzQSItTqC: GUvDAblGay CmdRkbJDxo ZROlhsbcUX
XnXHfOGufT: PxDkOIXzPd cUDWbCXGUj
HKzpDJzRvw: HeeBDgDXnW
AinQQqejoA: bmnqXspjiP
pNCwyeMqOb: eIkQtvdaJv BlmNqRJqXL pALIOPrQGn
ofrQqtgpmY: ZKDJEvEYiA
WgLPrttbso: FmFMopfJkP
HWBGxdFfcY: dzDIpxzxfQ
VwGHZlnkcD: BHSVYGakJF
NpzUbsXZbu: NaKlZZtlib
FRTbVPafWu: FgGtdqEjYt hzqUlAsOlF
eIkQtvdaJv: DRmVEfoZnY
jxmewkbIcl: SBKyYXhjQK
TNVmjsOUJF: gCUuwRptDw
jvwmvDyETZ: QRPHOkUJbf
pbxKSobQzC: zlZHZucNTN
ImdBCOmeyO: BAkLTXPbKV pxhXQIoYHc
ElvBzmoMLB: kEHAcCawYl
FqFWKBUmcX: TOgfkrUicG
VrHzckUBrL: geqpQgBZHh
iHmFmsbrAe: dmPSLwGWKZ
wvVSEHHYPk: cHoetsVSLp
kbDXSBHiHD: IOLJkGqjVG
GRvnNsGjyc: gZDuiepkAa NxBrinIjwk
avIBlvKDcb: KNCQztzDKN
DRmVEfoZnY: yaVWBqlKGs pVGjZYCjAb
PxDkOIXzPd: hcgymOqqYB sTLznKAEyh
KIvOXjHgpv: WzHdOCGogs afqQOWtQoD
LmXybJIvXF: ljSlYVQsoV
iIGVPZJzDL: lKCRAgCuVm
imXBQbChfB: zWApiatrPC
dJLpCGNxoT: DLxKhUYIjj
YFhAYMRsnm: tksotuPTei
SVgXkuDkpb: GzIOBOPhba IVUYrRMmKB
EiMvyhLzvD: BAAPBibmSI sjXDjrZxWr
fhxcsxrHQu: MlGdCnOxXA
FgGtdqEjYt: WmmxnSrARm
ZROlhsbcUX: HfLrYmulrs
SgTNIgEPSR: bMjSJYzCnn
yaVWBqlKGs: mFkadItsAU
HhEfWkywIq: gppaZXvUyO
hcgymOqqYB: adnxSJeVMa
sTLznKAEyh: ryMpzkSpwW rWtPHuEkFf
FgajxWFPJD: LXITniQZlJ
lQdKRRXgny: HqMYMOJRjC
hzqUlAsOlF: diCLvCcmFi
RqYuAXPIar: iTBSTTmESo
zzmUhTfWUh: jXKJzwszIm
bmnqXspjiP: KZVbAuuNFM MYtsoEQzkZ
ZiPhjEzpuf: FrJOUSiPGX
cUDWbCXGUj: sLcJheQIIF
viSNtlbgCc: xHtucHdlRw
jMnDMIMiRm: gKKKfpWdpH
bOvmYdCcqG: MzILHihabb
uojiAZWBeC: YoFEhPECff
afqQOWtQoD: GbZHrqjzGS
vOapPNTAwR: HmFIHvcDnN
ainxYXyRWd: yQRhUkNcID
dzDIpxzxfQ: LrowTpBZKY
rWtPHuEkFf: kThdgdpvef
