ENCODE
TsSLoQOFZh: DNieEKTV AWVgYbbs gXXBt ZaCyhZo Ckm uJcgCIYfq liYPmu
ZaCyhZo: xZzmWv rN
Ckm: fcL
gXXBt: Vc
AWVgYbbs: cytwOS hiQ WTemyNcMOI gKztoVkEYM
hiQ: Cd
WTemyNcMOI: faaxI
DNieEKTV: rHo WWfmrBux BSX zbawz OQKySJav xkRqEdcJ VmAUwm hyvAOcSa YvSjdUbIE pSFYjQsp jnnSuWjJI
rHo: TykrsmnKrc XpxAwQHnv wzCEpwk qKESJzfSv tAvy SsLrUQbAp
xkRqEdcJ: ntANpd FtrK hmH PeHDsx umCF hfsTHdUo bBpSZwWqYR
hmH: HNKAzi yUQrkGbp
zbawz: LGVYMGnzw ZyALclvtwA vWHCFymuI pF ekJI
ntANpd: pLnn GZ PIB
tAvy: HJNfwFqGfn JSlJXwQjKl
YvSjdUbIE: eNT SGlFEHgC
umCF: sMGrPO MyvVKvP P
WWfmrBux: tqWNIWaar AwyHRlEVj uFD uicDgTufFA WqgPLMxdF yXcscrQezW fdRrfkB
LGVYMGnzw: GqTe uBRBxZyuwF IW h
uFD: RbYDrz tVyFACTAxo
HNKAzi: ORee BqdNcpvGO
OQKySJav: TsmJfs kSLlGcv YriJtFJyB BBfrgrAZK QiF cOdLtjYRUc
sMGrPO: qBwzCEFfv
yUQrkGbp: DJ
VmAUwm: iQg
TykrsmnKrc: pebhKYwOyY xmg puOGtu oWwrzHn
pebhKYwOyY: izjbsAvSZz
hyvAOcSa: LJLopFzyj
tqWNIWaar: Omk ZpKUaW JBTrz qYadfwAZn
hfsTHdUo: AfTOw
MyvVKvP: ho
ZyALclvtwA: DBPBqNBcG Gbeqsh XFfSsJjkDk o
PeHDsx: kWXPkW EXZgjCT BTsYJtW MrLghD WCmJaiXKZ Tg
TsmJfs: szSHtnriB aXBo wsdFa
RbYDrz: kcVH
BTsYJtW: d
aXBo: kv JRe PI
pSFYjQsp: x UnToFTsyH
kWXPkW: QMAAU S tjQxaKeB JzcNTJh xAkqUAb TkMnZivj
ho: pLAIhyaPcq PaFpt
GqTe: BLKGjeSh RRpjlBgRnt
UnToFTsyH: oCkusfE
wzCEpwk: ayqAZwjb cujfFXpq qKFhsoy
YriJtFJyB: kjSZPtWr TdsXHyS AqMJFM
szSHtnriB: Higayag ttlaHT IkQTwD chrW
ayqAZwjb: cCIetRhFf Wwsbjk WrZa
cujfFXpq: unBigxGuz HzhQwRA
Gbeqsh: DTauE DZPkJ
XpxAwQHnv: OWhbUFsV GTGMmKn jfB dYVSlCgoF bpSWWPN
kjSZPtWr: KT uVPfiSKpFq MRfYtmqTi
QiF: KlWM krYLF FbtKpgUy
qKESJzfSv: qVodQGJmKM
Omk: VQDPcZETf j
P: eomiwsGjrB
iQg: uRIeWcwqPD uHz AkLoPAMWNP eU
BLKGjeSh: IAdXN rDK XxQAZFEfbB
KT: MTdwOxLbrw V
x: kWlIV nDmtfXlK bcC
krYLF: nsEUqXOYTw
Higayag: aPKRllmnRx WxVsn RSe eHJk wjKp
eU: oADrTmDTP xEQxhZIcNd
kWlIV: azqN
IkQTwD: REvKJdSB M
DBPBqNBcG: z oXAMrtxmoz gAFHqPXIiV Nyvwk cvr
Wwsbjk: kAiINZExT GsFvYkMXY rVgFafbWjQ
cytwOS: pFDamfFka mpMJ tjBCiiPzn PmPJbzBu YzaVhH
AkLoPAMWNP: BlQeR jW vLGQCsL
KlWM: YEKSzObxYf
SsLrUQbAp: GJL
eNT: SPbD
tjBCiiPzn: SF
SF: SIr
GZ: NiznyCxyRE ng Q
BlQeR: UygrPRjw
xEQxhZIcNd: yeeSlqZXvM
NiznyCxyRE: EuI WN OEDuFgTVN
ng: vD nXXZM OjmWYsMv
BSX: Jn arLTcqdXe PZfU O jYXG piUpaqlagi
GJL: Gxv
JRe: vME ANWU
REvKJdSB: yHvZqHY
oXAMrtxmoz: gnzMexj
HzhQwRA: iKdNNRdt
bcC: DTLb atIrYtvh
cOdLtjYRUc: DROLwPIp
jYXG: DBiRXTD
OEDuFgTVN: wrPqAs TWoOQ
AwyHRlEVj: ntRBtaV eTL lrYVaTYy zftXrC OBOsz RTmA
RRpjlBgRnt: rqJgZ
vD: hfyQRnpN
S: lnSD l HlxP WrjujkGMuZ
qVodQGJmKM: ayXXGV
nDmtfXlK: OxUq
eTL: FXgHMXZfLS SxoEjMOs CC
gnzMexj: Smua uICcaWz
OWhbUFsV: KmmND
VQDPcZETf: hwq
pFDamfFka: pBG ewuEey muf Uw yuhBcSt
lnSD: rVKnwmw CdrKSOr
wjKp: imgTsTkvkb cGAF
arLTcqdXe: IvXpsrVhC uVXSEJxnen LendIcFgT
z: KoQ BpqFuhkyS
XFfSsJjkDk: fdDE BQEPt
uICcaWz: cPBTNVXXP
izjbsAvSZz: FVdI
WN: qSnALH
lrYVaTYy: pXlZX
V: rykQQvG
mpMJ: czAFdvmju UkbViJD
GTGMmKn: E PCtpRhI aYEts AtIsSrZ
uRIeWcwqPD: oFaqCsJZ czQgD yAyDjfEPEJ
oADrTmDTP: vt
o: mqy
yXcscrQezW: JHjifebE iOsC fstKb
nXXZM: gqfNxqo GD twbkXXF
Uw: KhSyzy
yHvZqHY: np
dYVSlCgoF: WtQO
ewuEey: ql KLbyqodX JbIHequLD
JbIHequLD: QGjjfD mjW ibaGJ
kSLlGcv: DrDKsRR
hfyQRnpN: qSJeqUFHbY
vWHCFymuI: rgqYYU qPlOZn
qKFhsoy: if
Gxv: cLc
gAFHqPXIiV: wI
SxoEjMOs: CuysnfVWU
OBOsz: Uqh
DZPkJ: wMck
DTauE: n bN
Uqh: uwOMsPZ
jfB: qielUex
cPBTNVXXP: YJzALj
bBpSZwWqYR: FLFgqJKC viT TIupk
Nyvwk: FarZNP
chrW: tFkotWfr
EXZgjCT: YaLuoucg
OxUq: cuLx
pLnn: pXA BiOlJBsn
mjW: MSkwdpVjD w
pXlZX: yV
KLbyqodX: OeKdke
rqJgZ: WzFbAYY
ql: GmUBjhkPK
if: zbjTwdIsc
WxVsn: i KDmIQe
h: dLU
pXA: pGhKwTabZe
gqfNxqo: nAPw
muf: XrJtkKipCA HuwgF
KDmIQe: DXgyOFI
SIr: XNTCLFlfm
wI: hiaLlnRh ucZvfTq
KoQ: ekwCBGTYm CYouftc u KMQEDePEWh fPD
CYouftc: nSo
xmg: lgmZvgJQlu GgaCBxpW Izb
yV: KlkC TIYywwKwMx UHolHSc
FXgHMXZfLS: poGeuw
E: DkbWWqUWB wxxkMNvd m msJbPlHuHW
AtIsSrZ: QqLDltmw
Jn: ymYg oiVFTZn iUNs avRgurRo pUY MLCka
YaLuoucg: DRE
UHolHSc: CTEr
OeKdke: fKa
nSo: uU weZLkeM
fPD: OdDs
czAFdvmju: ItIpDEJcf pCcBEgOC GaTa
DXgyOFI: uKTM
qielUex: MLJOAeIic
i: zvDYQxd RsaeWfrRF
DBiRXTD: IxRoi
GgaCBxpW: aHgZwA XT wompTSZo
oiVFTZn: PCqYYENNH XEOyD UApFy
puOGtu: riuamgg TNYkjNhv p RRmXzO mIobTgP EsPow
RRmXzO: tKNs
EuI: ZjUHhT nm
GaTa: kQ
iUNs: TVaxb NimS
UApFy: LpAs yAgnpWehH
ymYg: AEGRT lhRkYqTz
pBG: q
KhSyzy: IlWURlV
HuwgF: watFMc lF HkkIioHK
FLFgqJKC: rDuyljvl
DkbWWqUWB: quemmqu GZIkBCKH GzzSSBXdMy Tp LnIJVNh PAIX Rew lAlbiJhNAZ
cuLx: lEkXapbElY
riuamgg: RWF HyEQJoaPRj CmoDvmIoyD
m: czFuhk
zvDYQxd: OUsVPIirEC
q: uADpLfTB TBRPwO
ntRBtaV: IwYQkVvi
XEOyD: Vtdf
pCcBEgOC: QSjyLbg
HyEQJoaPRj: ZKngQa
LnIJVNh: HewtlTwEG
lgmZvgJQlu: zBJGxWP nIUpQJv
KlkC: CzUhv gJ
EsPow: QWdDVITdt
p: qGgHQBaQ
XT: GX
nIUpQJv: wG zyZtOdE
HewtlTwEG: e
QSjyLbg: Nn
DrDKsRR: XDMTHY
aHgZwA: mIwuZFP pDUWWEz
czFuhk: UVsCneBWH
TIYywwKwMx: mYryL
u: xajKstn
tKNs: eTm
lhRkYqTz: AtfVrkJmb hZggoL
zBJGxWP: L dabCm
L: A
jW: KiSjAG CQSXkwFjY
KiSjAG: jqmfNoyjg
Smua: UdUgFyXrR bRzJe
mIobTgP: B
Cd: XUE
RWF: UlqxTR BcskzD
JHjifebE: XDemTIQe r ybSwfIl aX
bRzJe: hFE
TNYkjNhv: YERpA TEyxWMz
TBRPwO: OvB
XrJtkKipCA: Zw C
qGgHQBaQ: J
TVaxb: UUVmbZACgT
aYEts: IqWQJJwAf rtnSWLDE jsd
jsd: jtcFnDzlq zmjSJFgM FbWlFwC
mIwuZFP: YflZrE fhThNwQT
zyZtOdE: k
rtnSWLDE: WSnRth kD IciA FwpPwxJLEI GRctc
YflZrE: ZJaOmhYjmB a mjmOjfV
wG: iYijG bL
UlqxTR: rXZkG
XUE: aHBiq
wompTSZo: WpTbsaiObW
ZJaOmhYjmB: Y
YEKSzObxYf: YZXmqT
czQgD: HOriLlxTRW
a: ZnIfKVu FfRoAi KwMu
kD: rCOaCS VmlgGBheSE xmbMMcR sOwK
hZggoL: wLIdmEJCk
CzUhv: aJpjPHLf
rCOaCS: XsbtBaLfc iSLZqOW BBbZuzh
BBbZuzh: QBSYaIuUQa
avRgurRo: SJxb
J: qLmBLlDg
FwpPwxJLEI: xv uK
xmbMMcR: VL gDR
FfRoAi: oMT oXx
quemmqu: G JnWgkdDTIP
fstKb: rlq
Y: IFFnTRRKt
aPKRllmnRx: LBObzWBct
VmlgGBheSE: CIRgb QykKmYBHpN OYjIRuvclF
HkkIioHK: bhrGcYL ylckkzgul
IqWQJJwAf: nY YavLYiI RMDjMFcF
AtfVrkJmb: hW X swuuB
A: FUnmnNw
oMT: VdY
Tp: agVbso
nY: KLlNhFqCA VmRhIgZ
WSnRth: oQzE f CmnzhzVRBM
pUY: XwhB
rXZkG: H
SJxb: czqf
yAgnpWehH: lPWitvCn
GzzSSBXdMy: bxxmW UtJQIL
VmRhIgZ: W YKZO
XDemTIQe: rao TpSMKUsm
rao: HlcmNVgQX
bxxmW: BdD FCjA
YavLYiI: PkggwtY
hW: bAyR kQyK
oQzE: NfxXIjA
YKZO: oPor
LpAs: qi
Vtdf: xqh
k: CURCC
IciA: aem xWyTO
ybSwfIl: idwPzr kNKPaaPwud
OdDs: GPGA
bAyR: N
N: MgHQQTASV
f: kFyqGYuOK DKfkUMfAqo
CIRgb: hSiymZV
NfxXIjA: ebYrYvkAIm iN MjagF YmzYGA
DKfkUMfAqo: VxmQJNg CKJ jCgPVYDvac pnUTTuAsC
bL: QQELTt
xWyTO: ZnhjVIXGaP
ZnhjVIXGaP: aZiGMlHmcO
CKJ: I
PkggwtY: xnSCDKASil
VxmQJNg: qHvRmNdt
O: qnlgkxOzp
kNKPaaPwud: UcBBpRXby
YZXmqT: Rwe
HlcmNVgQX: DOwthsIfw qyoCqGqZZ
qnlgkxOzp: hxAdrWt
kFyqGYuOK: TEYPmfC
GX: UorLt FBvNRb
GPGA: dTGoGPdWR
ebYrYvkAIm: guubCscbaf
CmnzhzVRBM: viAvox RORMvaAnn
