ENCODE
wsVtGGqvLn: kNAmFdfIfj FguZSPaEjj
kNAmFdfIfj: BdJhUuNxpv
BdJhUuNxpv: mIkHEPlmKA
mIkHEPlmKA: jycQygiIbs
jycQygiIbs: amHLpUHneD
amHLpUHneD: RIoceXUiUS
RIoceXUiUS: ZkgaSPZWuZ
ZkgaSPZWuZ: lOLDfRbuMl
lOLDfRbuMl: NkjhQmqbwj
NkjhQmqbwj: nrCemRWKnJ
nrCemRWKnJ: ELWymnBSjy
ELWymnBSjy: mtQMhVvHVT
mtQMhVvHVT: okmVYzBElS
okmVYzBElS: YlLLlWGRXo
YlLLlWGRXo: SSNPpNiman
SSNPpNiman: SEMFsFpyqC
SEMFsFpyqC: McIjPiUZuC
McIjPiUZuC: YWoOHoMMSR
YWoOHoMMSR: eZKYacmbHw
eZKYacmbHw: DloYaLZXkW
DloYaLZXkW: mOZPaKmKCx
mOZPaKmKCx: deuBvDeiQi
deuBvDeiQi: hyIyFyBopy
hyIyFyBopy: scRyGzTUVK
scRyGzTUVK: NlLGoYSGrK
NlLGoYSGrK: dPskxmFFia
dPskxmFFia: PpyldYewfx
PpyldYewfx: WcYsEgMxxL
WcYsEgMxxL: wwIVjltQDJ
wwIVjltQDJ: QupfIHMgIE
QupfIHMgIE: cbqsQfwOpw
cbqsQfwOpw: KbNwcIBkWp
KbNwcIBkWp: CUhNvBpMZa
CUhNvBpMZa: JGoJxyjjGP
JGoJxyjjGP: nnZLcbYVky
nnZLcbYVky: VkAJpkvgLZ
VkAJpkvgLZ: YglTLtjUbJ
YglTLtjUbJ: CkYLGwxTZm
CkYLGwxTZm: VnXmmROCbi
VnXmmROCbi: XfZNFZgzIu
XfZNFZgzIu: zpiVyrmcQt
zpiVyrmcQt: SyfLMTMBoA
SyfLMTMBoA: HgPROQpQyl
HgPROQpQyl: ZMKjXVgVTG
ZMKjXVgVTG: GnBRhLIVwQ
GnBRhLIVwQ: IhxQHpLUnq
IhxQHpLUnq: DDYDOVFRJC
DDYDOVFRJC: NwiUnCVWad
NwiUnCVWad: RDpfPfadKm
RDpfPfadKm: RidpzmyMaj
RidpzmyMaj: xqlVcXWsBS
xqlVcXWsBS: PYewCCytQI
PYewCCytQI: KOIbRZDUEw
KOIbRZDUEw: HlJhUEqHzB
HlJhUEqHzB: WrRqNDdMiO
WrRqNDdMiO: vQYOZxFzNl
vQYOZxFzNl: AHicFpEmon
AHicFpEmon: uhvBZcCIYs
uhvBZcCIYs: XVObLWfpMI
XVObLWfpMI: AhutlUIuNQ
AhutlUIuNQ: tuNIoEcYGM
tuNIoEcYGM: nIWEZFDFch
nIWEZFDFch: DzlToajYZR
DzlToajYZR: yDCcaVmuvd
yDCcaVmuvd: PuadZwLPMd
PuadZwLPMd: LTPhrNnNlo
LTPhrNnNlo: AvBYAsqBRj
AvBYAsqBRj: nGUihmPqLx
nGUihmPqLx: vHaEwZwHUK
vHaEwZwHUK: BaYYZvTXQw
BaYYZvTXQw: jLPMbYJaHb
jLPMbYJaHb: DVapvpiggs
DVapvpiggs: ueywzQsJVT
ueywzQsJVT: hWcfVUzPtf
hWcfVUzPtf: iKUsHaXGYK
iKUsHaXGYK: bYToFXnbJc
bYToFXnbJc: xKItXiKmmS
xKItXiKmmS: mUKkrUcnHs
mUKkrUcnHs: NBGSjGaLDk
NBGSjGaLDk: bFHArPtSGi
bFHArPtSGi: yvxcNQdZDb
yvxcNQdZDb: LsjvlDuANr
LsjvlDuANr: AGmKLwJLll
AGmKLwJLll: GwjKzmbRjP
GwjKzmbRjP: ngDoeKullY
ngDoeKullY: aKMLcQJjmd
aKMLcQJjmd: nbvPfnmQyc
nbvPfnmQyc: ZHSgNYjxmH
ZHSgNYjxmH: rgEbEwOVQU
rgEbEwOVQU: NvokhJIxEc
NvokhJIxEc: cbBpkGavdz
cbBpkGavdz: LaWtaZPJiZ
LaWtaZPJiZ: PIgXkPnvOA
PIgXkPnvOA: JHLdFmylpi
JHLdFmylpi: XtaNXGjqiK
XtaNXGjqiK: ZzrbenBwWP
ZzrbenBwWP: yLWBAEAHMf
yLWBAEAHMf: CnKQsCLRLZ
CnKQsCLRLZ: GjowYrxjrB
GjowYrxjrB: TMmdOFNewg
TMmdOFNewg: GttwsrWNxu
GttwsrWNxu: tjEfsMmQCx
tjEfsMmQCx: RXxcEqElwI
RXxcEqElwI: oCyRNtXWAh
oCyRNtXWAh: SPngFzeLel
SPngFzeLel: zhyiqNSmfr
zhyiqNSmfr: SrVqPDPdlw
SrVqPDPdlw: GjwbeACRvM
GjwbeACRvM: isONTAOPUx
isONTAOPUx: oaHlTacpcS
oaHlTacpcS: huokxrlqlJ
huokxrlqlJ: NdEjdJmqpr
NdEjdJmqpr: BhgJPSeRdL
BhgJPSeRdL: NgZSmwroqk
NgZSmwroqk: mOGGeAnROJ
mOGGeAnROJ: oHPkJXHgKy
oHPkJXHgKy: UIjIfOYFGM
UIjIfOYFGM: QnAluuxPpA
QnAluuxPpA: GLnewbYRja
GLnewbYRja: OypbSkdhjs
OypbSkdhjs: MzQzCIPqmT
MzQzCIPqmT: oBzhFBdiCV
oBzhFBdiCV: lYVMkuaEDS
lYVMkuaEDS: sdmhIevbEw
sdmhIevbEw: SzPwqxOybI
SzPwqxOybI: UcvOzgRDFv
UcvOzgRDFv: WIseJoRflE
WIseJoRflE: uVicfrsTMK
uVicfrsTMK: EZEISmMxZU
EZEISmMxZU: BBFbmxMFVN
BBFbmxMFVN: yysQbPOSAx
yysQbPOSAx: BtuYeAHdNI
BtuYeAHdNI: ThhLhhCoYm
ThhLhhCoYm: GJHarwiClM
GJHarwiClM: OGiuCeVoCp
OGiuCeVoCp: ESqXiqSPjr
ESqXiqSPjr: GKAGVdbScF
GKAGVdbScF: JmgMDJpevz
JmgMDJpevz: AjvFxyVcmh
AjvFxyVcmh: xXVBbJxDbB
xXVBbJxDbB: sMRiGanSPU
sMRiGanSPU: JpuKjvBgEq
JpuKjvBgEq: CLGFrFWtUu
CLGFrFWtUu: QySxRtieNm
QySxRtieNm: NROWwhFkDc
NROWwhFkDc: ttYToQGAUz
ttYToQGAUz: LvwflaqkJk
LvwflaqkJk: KyMbKpQxnc
KyMbKpQxnc: PwkisejOic
PwkisejOic: crqPUWRhGk
crqPUWRhGk: TOMuCVKReC
TOMuCVKReC: yGeLgJyFle
yGeLgJyFle: vrMWnMhOuE
vrMWnMhOuE: lOnCDXtvpF
lOnCDXtvpF: tMsGYkyCBW
tMsGYkyCBW: bvTUbfvgqV
bvTUbfvgqV: FmwOznCKZH
FmwOznCKZH: psMEUJebWQ
psMEUJebWQ: fdVQiroCaX
fdVQiroCaX: EufzQIZHWv
EufzQIZHWv: lONnDikmUE
lONnDikmUE: JhdKZqwSYC
JhdKZqwSYC: CuJcCPdeQC
CuJcCPdeQC: VFAcPXcfOD
VFAcPXcfOD: UaworOmSou
UaworOmSou: wziYjwLOtu
wziYjwLOtu: TLkgQUoLYm
TLkgQUoLYm: lWoGLMQHiJ
lWoGLMQHiJ: ZLeIIjpuPB
ZLeIIjpuPB: ZfMuXvXAoV
ZfMuXvXAoV: KnVUfCREnM
KnVUfCREnM: TbQiPIhUIE
TbQiPIhUIE: skqdRflGpz
skqdRflGpz: YsryzJuvUm
YsryzJuvUm: fosySRZhaH
fosySRZhaH: JrSLIbDPrz
JrSLIbDPrz: HNPzhQVIBO
HNPzhQVIBO: wPkvdzaQwJ
wPkvdzaQwJ: PJhacddEra
PJhacddEra: uBcROZYCUx
uBcROZYCUx: tdOqFIYHhh
tdOqFIYHhh: jpMoSRLBlY
jpMoSRLBlY: hBcVhjhppP
hBcVhjhppP: iqdmhTvZQo
iqdmhTvZQo: lTgeQiJrrS
lTgeQiJrrS: uEfUzwOpKf
uEfUzwOpKf: IBZsrccePx
IBZsrccePx: vjCxUZvQYp
vjCxUZvQYp: IzUeyuqCvO
IzUeyuqCvO: OxXEBbKNoQ
OxXEBbKNoQ: LxtPheDZcA
LxtPheDZcA: riHFPieEXE
riHFPieEXE: RLihHQGxVV
RLihHQGxVV: ihDAnRfmaf
ihDAnRfmaf: VUblCmscVu
VUblCmscVu: uWsaBuYoRc
uWsaBuYoRc: ocxTtroslF
ocxTtroslF: DXKARnpDQS
DXKARnpDQS: aFpnxHhOEL
aFpnxHhOEL: XfScJbMNOc
XfScJbMNOc: vCyWzRUWGo
vCyWzRUWGo: SptvjaEsMu
SptvjaEsMu: cHkFTvIDhe
cHkFTvIDhe: jeYQpfdEYk
jeYQpfdEYk: mqKEofYKlc
mqKEofYKlc: ecMcKPOeHq
ecMcKPOeHq: YzNaHfXdGn
YzNaHfXdGn: WHXSmcZkSC
WHXSmcZkSC: BwFBWpxqYB
BwFBWpxqYB: aOCdAioIUv
aOCdAioIUv: ILcnVUStlv
ILcnVUStlv: HafMFnDFnP
HafMFnDFnP: ZYKFXYshLI
ZYKFXYshLI: lSXGhZyvHa
lSXGhZyvHa: fJDUJlXGDM
fJDUJlXGDM: wVJqKiaHgB
wVJqKiaHgB: YKyEpJLMxG
YKyEpJLMxG: zmeKCCaijL
zmeKCCaijL: eSHxwjaefJ
eSHxwjaefJ: pJobDPjQGh
pJobDPjQGh: TMoLkbuLbY
TMoLkbuLbY: ESpwftPWeY
ESpwftPWeY: ihthHwJSoL
ihthHwJSoL: lXpLvxrNVo
lXpLvxrNVo: XPPEfAJOcH
XPPEfAJOcH: WLiDMXePuJ
WLiDMXePuJ: llDDPjvCfz
llDDPjvCfz: IwxdDXTbdr
IwxdDXTbdr: zofdAPRIKJ
zofdAPRIKJ: XPrQvlFlUo
XPrQvlFlUo: MjxyQiQmIb
MjxyQiQmIb: ZDSHLGJYke
ZDSHLGJYke: TdiyMaNKSw
TdiyMaNKSw: DSeMLZtDba
DSeMLZtDba: cqaoyEFiEF
cqaoyEFiEF: OzWIXSxuOJ
OzWIXSxuOJ: wDysNhCoGc
wDysNhCoGc: IzNugOSONM
IzNugOSONM: ovoZbLXUQl
ovoZbLXUQl: HuJSwyYbRX
HuJSwyYbRX: fRLMxFXwzE
fRLMxFXwzE: IvgXlkeNbG
IvgXlkeNbG: HtuoTNAoSt
HtuoTNAoSt: BExlaxYwNW
BExlaxYwNW: dUJqsCCofd
dUJqsCCofd: elsWriPUVl
elsWriPUVl: UwwujeNPEn
UwwujeNPEn: EPyXmevkZs
EPyXmevkZs: MFetZdDFkz
MFetZdDFkz: xtNufZPbWL
xtNufZPbWL: iITIQKHiQj
iITIQKHiQj: qHndiQPOqI
qHndiQPOqI: SKmUKVHGQU
SKmUKVHGQU: RSItvCWngP
RSItvCWngP: ITxJMEoOSq
ITxJMEoOSq: kpTmCDBgeF
kpTmCDBgeF: LsEaxhLczQ
LsEaxhLczQ: uugBScyvae
uugBScyvae: IebPbAJDaJ
IebPbAJDaJ: pobKsppYww
pobKsppYww: CpfssNtySI
CpfssNtySI: HxbugCCbMX
HxbugCCbMX: QQAFtcDfZe
QQAFtcDfZe: GCqEknNthP
GCqEknNthP: WNvGXXRzxD
WNvGXXRzxD: GjfScRIztB
GjfScRIztB: AnElUoRBSd
AnElUoRBSd: otYHWcTCfP
otYHWcTCfP: DNRmoLMADw
DNRmoLMADw: GCCAoYaEzl
GCCAoYaEzl: qQJoDdQkjQ
qQJoDdQkjQ: VbMbqPIZSx
VbMbqPIZSx: nURmrIOfrO
nURmrIOfrO: zLjLatxLse
zLjLatxLse: kCnJoqBThS
kCnJoqBThS: OvOhKdcEGB
OvOhKdcEGB: RALRoqGSUO
RALRoqGSUO: WuXUtqkHVQ
WuXUtqkHVQ: ILLPMVAgZD
ILLPMVAgZD: oaYBimCVBu
oaYBimCVBu: nvLoOnrHht
nvLoOnrHht: RAmJEImzxl
RAmJEImzxl: uZdQgWiLzp
uZdQgWiLzp: QsXqJnCrDg
QsXqJnCrDg: ExrEqEvKez
ExrEqEvKez: tVWaTJIPnL
tVWaTJIPnL: UVUomtMrjo
UVUomtMrjo: rQIEBjqHNI
rQIEBjqHNI: BlXqCsgNLA
BlXqCsgNLA: OJWzIwlbxT
OJWzIwlbxT: bhnGyiZwvw
bhnGyiZwvw: UdBEgsJapn
UdBEgsJapn: ybQFxwoTGf
ybQFxwoTGf: gpinZOTpMW
gpinZOTpMW: GKvuWHnAqI
GKvuWHnAqI: LlqmHDNqpz
LlqmHDNqpz: FLQjQrdIwA
FLQjQrdIwA: IvpOEASowb
IvpOEASowb: XefQkuDKbi
XefQkuDKbi: LENzPqjNfO
FguZSPaEjj: RriIDOIghE
RriIDOIghE: CMFSdPfoEr
CMFSdPfoEr: ggkWEZmTLW
ggkWEZmTLW: YRNAgMuhNr
YRNAgMuhNr: xuuseDDcTv
xuuseDDcTv: jEkMMwFwXq
jEkMMwFwXq: yYaHzsdeea
yYaHzsdeea: NyBexAmmGo
NyBexAmmGo: ehYyXASUFo
ehYyXASUFo: kYyqKUmIuG
kYyqKUmIuG: CReMjYsoZf
CReMjYsoZf: mYnKcORiew
mYnKcORiew: sNGzRYlSqO
sNGzRYlSqO: IrHKhJEUkd
IrHKhJEUkd: XgvUGDYZXl
XgvUGDYZXl: fBEpaAQQQN
fBEpaAQQQN: zzfugAXpny
zzfugAXpny: wOKRbHCqCw
wOKRbHCqCw: WmqWiOSxsJ
WmqWiOSxsJ: aQlIDasgEM
aQlIDasgEM: OCFxTqVyNz
OCFxTqVyNz: xziTZTleFL
xziTZTleFL: AwfKbSJVZl
AwfKbSJVZl: mBDqLrwaHL
mBDqLrwaHL: SbnronoLXO
SbnronoLXO: GlxtcPhktY
GlxtcPhktY: zKYCpeBQRc
zKYCpeBQRc: KVabjsbbJN
KVabjsbbJN: jtQLnuVCLc
jtQLnuVCLc: OxauIZOrgm
OxauIZOrgm: sujhHanBdy
sujhHanBdy: dwOqSdtMuj
dwOqSdtMuj: ctkbbMKpQm
ctkbbMKpQm: hbJLBRxfUT
hbJLBRxfUT: uxvHnWmOMQ
uxvHnWmOMQ: fWBuEVxsna
fWBuEVxsna: rNkYAFapoh
rNkYAFapoh: dcYxJLgPza
dcYxJLgPza: yCEXwqiaTI
yCEXwqiaTI: WANCBGKyGz
WANCBGKyGz: vYUivCInFb
vYUivCInFb: OiQkLJXRfh
OiQkLJXRfh: HEkWFDZCVV
HEkWFDZCVV: EUuezuAddK
EUuezuAddK: JzALDLIorj
JzALDLIorj: EStXNSaIMy
EStXNSaIMy: cSPQqsrxLv
cSPQqsrxLv: BngGBGIqUo
BngGBGIqUo: rZDEmMaIGm
rZDEmMaIGm: OnDAJhGAMe
OnDAJhGAMe: RNiRrkMYee
RNiRrkMYee: eANWNiJmhe
eANWNiJmhe: eHWMRkBteK
eHWMRkBteK: AxylntawxO
AxylntawxO: OPasAnTbeX
OPasAnTbeX: PcXKeKOgQF
PcXKeKOgQF: SrisfOOlun
SrisfOOlun: lOKdIqyxwV
lOKdIqyxwV: pPpAyamUGp
pPpAyamUGp: GRIVrqLMBg
GRIVrqLMBg: iIcHWoTgzG
iIcHWoTgzG: NNeQTHeDTJ
NNeQTHeDTJ: vLhMqvYNxa
vLhMqvYNxa: xTJokcvyDr
xTJokcvyDr: qMzReIxHSK
qMzReIxHSK: XQmINLSoFc
XQmINLSoFc: aXsBHKIRld
aXsBHKIRld: FXhpEHJCzj
FXhpEHJCzj: oVAMOgCYjf
oVAMOgCYjf: sehLLzJYpI
sehLLzJYpI: cVRhTIMMyH
cVRhTIMMyH: waKLybMtUl
waKLybMtUl: bjqSUDYYIT
bjqSUDYYIT: HBUiuJVJio
HBUiuJVJio: eSNuBXmmZL
eSNuBXmmZL: YxIlUDGzIe
YxIlUDGzIe: fkQKkKUJKw
fkQKkKUJKw: omDBRqusoG
omDBRqusoG: oiMppsdUtN
oiMppsdUtN: hQljAdVTdk
hQljAdVTdk: xNwmgLNhVL
xNwmgLNhVL: CwyBDjJwCn
CwyBDjJwCn: gAqoySmkrN
gAqoySmkrN: YwZuxcnsRs
YwZuxcnsRs: oCVMAgUsjd
oCVMAgUsjd: AKphlRBjlO
AKphlRBjlO: LiNdauDlZb
LiNdauDlZb: PXBBGyQsay
PXBBGyQsay: HVpWJOQcot
HVpWJOQcot: KAcMhsnpmT
KAcMhsnpmT: wLAFWEMYVS
wLAFWEMYVS: kvHLvkbOdj
kvHLvkbOdj: QlSIcckeKT
QlSIcckeKT: LtzjqUzRgP
LtzjqUzRgP: TcPXsgVanj
TcPXsgVanj: HDRrqNKfES
HDRrqNKfES: pwoHiBrSVo
pwoHiBrSVo: zaXpqqrIwy
zaXpqqrIwy: dYsjvfnfGP
dYsjvfnfGP: XBoXdBABIP
XBoXdBABIP: GWIxRSytQE
GWIxRSytQE: bSHTZbXXoM
bSHTZbXXoM: lKPeDiAEoK
lKPeDiAEoK: FRhcgeTAPP
FRhcgeTAPP: JUDiZGOPGE
JUDiZGOPGE: DVBXxHHRAb
DVBXxHHRAb: fOoPMcNJBD
fOoPMcNJBD: mRdxJLoajv
mRdxJLoajv: QoYffAKQun
QoYffAKQun: eowiMVJPBk
eowiMVJPBk: nWpetvGwGr
nWpetvGwGr: rKGbzMSpmT
rKGbzMSpmT: pERzsBQuCI
pERzsBQuCI: TDkDHIBQmq
TDkDHIBQmq: asZhCGcfWm
asZhCGcfWm: BGYVwAeaDI
BGYVwAeaDI: VtGUJZqHAb
VtGUJZqHAb: WjOVLAQxFn
WjOVLAQxFn: LFxvlNYFla
LFxvlNYFla: YqhShaMOlM
YqhShaMOlM: rWZZsYVuFL
rWZZsYVuFL: QSWmhVGAUU
QSWmhVGAUU: GFjfTpwWHT
GFjfTpwWHT: BSuteyZGea
BSuteyZGea: NrCStkgJHz
NrCStkgJHz: jsKhcjHWPf
jsKhcjHWPf: VKgDBxEfLf
VKgDBxEfLf: iznXYxgcrl
iznXYxgcrl: MgMPyEzWHa
MgMPyEzWHa: owaKiIrAEx
owaKiIrAEx: YLBEpZjxzJ
YLBEpZjxzJ: qGOPaHOjyf
qGOPaHOjyf: xxcnydgxgG
xxcnydgxgG: FzMmiAPljY
FzMmiAPljY: wsWmsgVlTD
wsWmsgVlTD: KICbtOIAUF
KICbtOIAUF: nENxOxcWET
nENxOxcWET: ymDTUHvnVF
ymDTUHvnVF: ZURINukBtP
ZURINukBtP: hQGPwtpAfN
hQGPwtpAfN: rreTSYcxkQ
rreTSYcxkQ: hKdbpaLhHQ
hKdbpaLhHQ: mWxuRLBYwZ
mWxuRLBYwZ: qmufiqzLsh
qmufiqzLsh: qADdPlSFmr
qADdPlSFmr: PrVYYCmUSw
PrVYYCmUSw: iOCiNNWjGM
iOCiNNWjGM: mTZBPxVcvm
mTZBPxVcvm: WhQpFLbNBg
WhQpFLbNBg: UkTgqvFgor
UkTgqvFgor: sqeVCzdomH
sqeVCzdomH: HjijOPTphB
HjijOPTphB: muNOCYyCoe
muNOCYyCoe: XWCyVpGvXd
XWCyVpGvXd: ScnyRAiVdm
ScnyRAiVdm: gBUxwzFuPA
gBUxwzFuPA: kesEPkWKGC
kesEPkWKGC: FkldOIfjvJ
FkldOIfjvJ: hDUKyeXFsg
hDUKyeXFsg: tNHJwyNRYD
tNHJwyNRYD: OBPybgtptQ
OBPybgtptQ: FTKdZnxkmg
FTKdZnxkmg: ANOEvVlKvj
ANOEvVlKvj: jwJhDfjAPn
jwJhDfjAPn: ghiKpUWVKO
ghiKpUWVKO: xNlIzndOUI
xNlIzndOUI: rvLdAbrlyF
rvLdAbrlyF: DoHOeaRaOD
DoHOeaRaOD: UevnRDqlkI
UevnRDqlkI: YTdMAvwfOP
YTdMAvwfOP: EziFuQclTe
EziFuQclTe: SkrxxcUdAR
SkrxxcUdAR: LutHvOCajx
LutHvOCajx: BOpgiLISYt
BOpgiLISYt: tRYeVVTGry
tRYeVVTGry: ivXUvjzxTM
ivXUvjzxTM: EVvVjSYykT
EVvVjSYykT: cUsfOfesVK
cUsfOfesVK: uybqIPSpYn
uybqIPSpYn: YwvKSibNJz
YwvKSibNJz: iUjiengmcS
iUjiengmcS: hmxqofpfaj
hmxqofpfaj: yIgvGMJeWd
yIgvGMJeWd: lgymZEDylt
lgymZEDylt: UzxhOTvlol
UzxhOTvlol: EmGomhITQy
EmGomhITQy: WYMAhsNVZb
WYMAhsNVZb: GcGmFQhLgy
GcGmFQhLgy: nqdYFCAeLj
nqdYFCAeLj: fxZcDYvWGF
fxZcDYvWGF: KJKkssObDS
KJKkssObDS: fopwBIDzjx
fopwBIDzjx: rUDyLyqWtx
rUDyLyqWtx: uBavLfsLAI
uBavLfsLAI: KqNdBReEDL
KqNdBReEDL: LsUWrOmGzB
LsUWrOmGzB: zztyBTuqHv
zztyBTuqHv: DVKhoxCymN
DVKhoxCymN: pJVXQSNJOg
pJVXQSNJOg: QGaLwHEnuQ
QGaLwHEnuQ: HPDFIqFkkc
HPDFIqFkkc: EWqrATIUoT
EWqrATIUoT: gkhfqUklUb
gkhfqUklUb: btPgGKMFwV
btPgGKMFwV: GnDYdflQBz
GnDYdflQBz: CSziUlvIAY
CSziUlvIAY: ZbROpMBfJH
ZbROpMBfJH: ZZhpjCpzOD
ZZhpjCpzOD: XRXPLHWyOB
XRXPLHWyOB: kxZmNLXlAp
kxZmNLXlAp: zMDkaGPveK
zMDkaGPveK: BRnaYrlToL
BRnaYrlToL: AIsXhghKzC
AIsXhghKzC: jABwddghGM
jABwddghGM: wtjyuwICjp
wtjyuwICjp: ZnlpQGljYD
ZnlpQGljYD: tGJbfWlZep
tGJbfWlZep: nWErqrpOQt
nWErqrpOQt: JNUcuukiUB
JNUcuukiUB: YADStMyana
YADStMyana: swDrWmiFtS
swDrWmiFtS: UtKiXeXmkJ
UtKiXeXmkJ: vYPzwUDaYn
vYPzwUDaYn: UAqDPoTPjC
UAqDPoTPjC: pLaYjIUCkZ
pLaYjIUCkZ: NRuILHamEy
NRuILHamEy: PtNndZcCJh
PtNndZcCJh: FcxMcqBInH
FcxMcqBInH: VTDtovXQEs
VTDtovXQEs: kIYZaLGieG
kIYZaLGieG: CskIkWPVAf
CskIkWPVAf: YAvEctYJjL
YAvEctYJjL: iVvaRPpGYG
iVvaRPpGYG: yuytzLcUmT
yuytzLcUmT: cCgDgmGZgc
cCgDgmGZgc: dlCXKZOKFs
dlCXKZOKFs: PEEsUFEyhj
PEEsUFEyhj: dOQyWrYrTs
dOQyWrYrTs: JJsfKbBAdD
JJsfKbBAdD: hLMlpCduwA
hLMlpCduwA: qSbtsQbqyx
qSbtsQbqyx: HFRVejwfLf
HFRVejwfLf: JnfgdakWOd
JnfgdakWOd: fHMcvXyOWj
fHMcvXyOWj: tDhDPxlDcU
tDhDPxlDcU: EfjVhaTsdm
EfjVhaTsdm: UmFquuTVqD
UmFquuTVqD: ozMBNMHXQR
ozMBNMHXQR: PUeDAFJxaO
PUeDAFJxaO: nwEJuFcYUc
nwEJuFcYUc: gcCNPJJgFc
gcCNPJJgFc: uiAnQDGEJF
uiAnQDGEJF: wQPnZMgPFE
wQPnZMgPFE: eFhVEWFLWI
eFhVEWFLWI: bTDxWaGIrH
bTDxWaGIrH: nNoqpnJcLF
nNoqpnJcLF: BixcnuBHOF
BixcnuBHOF: UHRzjRiqhx
UHRzjRiqhx: BRrYnMrQUF
BRrYnMrQUF: rybnsyjkMB
rybnsyjkMB: RTeZKgCLMG
RTeZKgCLMG: epOnaKfhvo
epOnaKfhvo: MIWvYmvlCg
MIWvYmvlCg: bdCRnlJWLr
bdCRnlJWLr: JrcXCtRakf
JrcXCtRakf: EbdDoSTwzW
EbdDoSTwzW: BtWUaqlihd
BtWUaqlihd: keaVbSDfNQ
keaVbSDfNQ: WWdQyobGQp
WWdQyobGQp: DJBdNuKhSi
DJBdNuKhSi: owkuuCjWwZ
owkuuCjWwZ: ZmnCcfXWxh
ZmnCcfXWxh: bnbVsEHNUU
bnbVsEHNUU: VFuwmkYeur
VFuwmkYeur: RgTaezfhPl
RgTaezfhPl: EaaDNhAuON
EaaDNhAuON: OpoVuxYTEO
OpoVuxYTEO: uCcOEBvJGl
uCcOEBvJGl: hDgpgpKvmg
hDgpgpKvmg: pjhKjpBihs
pjhKjpBihs: ZePVHAJGLL
ZePVHAJGLL: pliCJrijxY
pliCJrijxY: SdEqBKNYsL
SdEqBKNYsL: qSsxCrKaeQ
qSsxCrKaeQ: EuayMnwAAZ
EuayMnwAAZ: jHnMbgNure
jHnMbgNure: WphGWLseXc
WphGWLseXc: ZmktjUuhOM
ZmktjUuhOM: voQSnKiHwu
voQSnKiHwu: oAmnXCEDpV
oAmnXCEDpV: QKHiSFWOTS
QKHiSFWOTS: IwfNWMfqIH
IwfNWMfqIH: sNifNVvawk
sNifNVvawk: lihumDclIW
lihumDclIW: VOKzwtntZR
VOKzwtntZR: PpaqaMVEZO
PpaqaMVEZO: ZGemKYMIbE
ZGemKYMIbE: LgfiJUFkzg
