ENCODE
vU: uxA qGQtwl CzKnx OKDr ZveAKFRuwZ NWDTJ A ReZvO AoZKIo PJDogWq ncxWXdbAKh MyiYebr qQSEaIjE fcOAwx YznyGbp ztVcz
uxA: ZQJI
ReZvO: GGo
AoZKIo: W
PJDogWq: RooBtPOK
MyiYebr: efrqeSN
qQSEaIjE: nmUJqEvi
fcOAwx: QVECvM
YznyGbp: fhFD
ZveAKFRuwZ: ku
ztVcz: BuGp
qGQtwl: rVDvcNgLqz
CzKnx: SpokyFOUPt
OKDr: qIgT
NWDTJ: IPFguFr
A: iPgbLETr
ncxWXdbAKh: PD
ZQJI: BohYfXo
GGo: XFG
W: pmY
RooBtPOK: QeKBuFrC
efrqeSN: UjDnXJXUS
nmUJqEvi: YiWaLePqXQ
QVECvM: hp
fhFD: LKcXPL
ku: gIxJsPcm
BuGp: WcunHxZM
rVDvcNgLqz: UMXu
SpokyFOUPt: NEJoi
qIgT: bfSpTPK
IPFguFr: AYxVCWu
iPgbLETr: HpRUtO
PD: XUAtLmWej
BohYfXo: ExSVB
XFG: gmwA
pmY: loWIWM
QeKBuFrC: SZAd
UjDnXJXUS: yRuEImPbb
YiWaLePqXQ: qxg
hp: Hc
LKcXPL: vHXrBV
gIxJsPcm: EOm
WcunHxZM: j
UMXu: ESqRfxAml
NEJoi: GF
bfSpTPK: UDPshWC
AYxVCWu: WlagzmoUo
HpRUtO: TaLuLUAvv
XUAtLmWej: IUtYatH
ExSVB: tdT
gmwA: xKtjOMnHus
loWIWM: WfotwDz
SZAd: yGiYJx
yRuEImPbb: aEUEBXmNj
qxg: RRcV
Hc: xYM
vHXrBV: vSo
EOm: QgfbBtWHu
j: OMEChYw
ESqRfxAml: GjKvyp
GF: NkcCQUd
UDPshWC: WwTZ
WlagzmoUo: CxhRqJ
TaLuLUAvv: WS
IUtYatH: jrtr
tdT: AhNPKoi
xKtjOMnHus: AIvzKYB
WfotwDz: nI
yGiYJx: IMozYcsVfB
aEUEBXmNj: VXEGfHirN
RRcV: IQZa
xYM: vSMl
vSo: LN
QgfbBtWHu: s
OMEChYw: qZ
GjKvyp: RTbfQZ
NkcCQUd: wjzJUv
WwTZ: uNiP
CxhRqJ: E
WS: koyxuWmiy
jrtr: DVdAZe
AhNPKoi: SUCU
AIvzKYB: bpFuhDItM
nI: IbVGsvCg
IMozYcsVfB: aXIPpFMH
VXEGfHirN: FYjWax
IQZa: MCdBdNhp
vSMl: bcnTmB
LN: ePSWjaJIKQ
s: uM
qZ: LSBAMPK
RTbfQZ: nnH
wjzJUv: blUkTw
uNiP: cft
E: ZqAtGeguUW
koyxuWmiy: RE
DVdAZe: Shb
SUCU: cX
bpFuhDItM: rTfxPCxB
IbVGsvCg: Rn
aXIPpFMH: GKZ
FYjWax: jwdnpJPhe
MCdBdNhp: YuhHUgjDx
bcnTmB: uGFnM
ePSWjaJIKQ: vmjwrZMwNe
uM: CEWxZcBmqR
LSBAMPK: Qi
nnH: MutrFCstC
blUkTw: mGPwsKTf
cft: JqoU
ZqAtGeguUW: HU
RE: gvnETaOIeU
Shb: EWr
cX: SMONEw
rTfxPCxB: ynBhQIf
Rn: uasSaTPrEr
GKZ: xgmps
jwdnpJPhe: AoAwpxmKmc
YuhHUgjDx: rqjDwCjtP
uGFnM: hPwpNo
vmjwrZMwNe: PTFpn
CEWxZcBmqR: bvbDMRoB
Qi: VIZiQ
MutrFCstC: DLlgmpy
mGPwsKTf: R
JqoU: KlVctBbQwk
HU: yn
gvnETaOIeU: dS
EWr: YWXGPJzSG
SMONEw: puzv
ynBhQIf: wa
uasSaTPrEr: CJiFMm
xgmps: IRJIWq
AoAwpxmKmc: IQfPZMes
rqjDwCjtP: DJmAnkGFdr
hPwpNo: VAr
PTFpn: iR
bvbDMRoB: h
VIZiQ: BhXRxC
DLlgmpy: FFO
R: OmhPbjhjtH
KlVctBbQwk: Zwh
yn: DcMr
dS: DtVymzJM
YWXGPJzSG: hzlV
puzv: XGbye
wa: C
CJiFMm: yOgjT
IRJIWq: P
IQfPZMes: cd
DJmAnkGFdr: SJemXqSJxN
VAr: r
iR: NHOz
h: UMuoEjWgg
BhXRxC: TnS
FFO: wULYVNkle
OmhPbjhjtH: WlAVlT
Zwh: wNEsFxDSYY
DcMr: atnkVp
DtVymzJM: AWk
hzlV: dzS
XGbye: CmYn
C: xmmPdPXXg
yOgjT: SWAoVMe
P: RsLYBcbIBQ
cd: tVnuz
SJemXqSJxN: ZGIjkB
r: rlK
NHOz: AkWpWb
UMuoEjWgg: AW
TnS: xKuIa
wULYVNkle: zgsvELau
WlAVlT: fe
wNEsFxDSYY: n
atnkVp: aDgEB
AWk: dYKcTR
dzS: QQaRIA
CmYn: dBW
xmmPdPXXg: FWlqHZCYgK
SWAoVMe: sTBjMfi
RsLYBcbIBQ: LFiaJtCfk
tVnuz: tYQXEyxsc
ZGIjkB: VKxXrDRIS
rlK: GJHCnAkZio
AkWpWb: yFrPFWO
AW: lnkKfRh
xKuIa: cuh
zgsvELau: naqPKPgt
fe: XjjU
n: faMfUcsIQ
aDgEB: i
dYKcTR: fO
QQaRIA: skXCTqK
dBW: U
FWlqHZCYgK: aRqgAzpD
sTBjMfi: FihsQpcsbD
LFiaJtCfk: xyybsKq
tYQXEyxsc: RxFH
VKxXrDRIS: NZqrrIBuh
GJHCnAkZio: Ey
yFrPFWO: SY
lnkKfRh: tBaRjzRVm
cuh: vSh
naqPKPgt: rjByEb
XjjU: ulgOJA
faMfUcsIQ: hsQLD
i: N
fO: Ch
skXCTqK: nNQQlQLzw
U: PiKUiVtsY
aRqgAzpD: cyOZ
FihsQpcsbD: DnrcA
xyybsKq: NXh
RxFH: pj
NZqrrIBuh: T
Ey: hQzYU
SY: TJhrec
tBaRjzRVm: qQRefsWG
vSh: AJ
rjByEb: tBdVQhCbu
ulgOJA: Pynz
hsQLD: JF
N: QxvlSEXEu
Ch: dUGLGSTt
nNQQlQLzw: us
PiKUiVtsY: yOo
cyOZ: EoYXfcdX
DnrcA: fXF
NXh: KX
pj: B
T: XgNZBrC
hQzYU: vZW
TJhrec: ckBPYdiJz
qQRefsWG: hvIdBH
AJ: ZtPs
tBdVQhCbu: th
Pynz: a
JF: FKAbvJnfF
QxvlSEXEu: tPdQppVOf
dUGLGSTt: GJTWOrGX
us: TvCoUiZq
yOo: YPUhbYTxGA
EoYXfcdX: IAwPrgDU
fXF: cO
KX: xzlLLfwcQ
B: Vg
XgNZBrC: ddplY
vZW: yEWbFQj
ckBPYdiJz: jKNpM
hvIdBH: AtIiLmJYyc
ZtPs: QxP
th: joyzUJ
a: zG
FKAbvJnfF: SBxkYFGRpl
tPdQppVOf: avaGDoJz
GJTWOrGX: bSCBdAPPAL
TvCoUiZq: WvPdnM
YPUhbYTxGA: RC
IAwPrgDU: XxHaDQul
cO: FsucrY
xzlLLfwcQ: IIzQ
Vg: fifP
ddplY: km
yEWbFQj: BaBNH
jKNpM: TcWVu
AtIiLmJYyc: ZUjKkSY
QxP: dtewUJeU
joyzUJ: LriXLlLK
zG: rpcdtFLp
SBxkYFGRpl: yLNHuc
avaGDoJz: HapAdcZBc
bSCBdAPPAL: BVandPmVwL
WvPdnM: Bb
RC: Wxoi
XxHaDQul: JTadWmn
FsucrY: CdM
IIzQ: tlAC
fifP: yuTo
km: CPKs
BaBNH: AVDrEBhsh
TcWVu: GI
ZUjKkSY: LgfOgP
dtewUJeU: ECBOSSrQWX
LriXLlLK: HkBz
rpcdtFLp: fyDsMutp
yLNHuc: JYAELvMjOx
HapAdcZBc: gEktpymO
BVandPmVwL: wTK
Bb: SyZWNVf
Wxoi: k
JTadWmn: LOfl
CdM: NSlBs
tlAC: p
yuTo: FnRFcJsdk
CPKs: Eita
AVDrEBhsh: HGobW
GI: UUDrDff
LgfOgP: yXmEaH
ECBOSSrQWX: aHoYi
HkBz: hpxgjhz
fyDsMutp: EN
JYAELvMjOx: JJyHBGU
gEktpymO: Q
wTK: z
SyZWNVf: YaNxa
k: oqx
LOfl: Ya
NSlBs: J
p: zhb
FnRFcJsdk: UZmIm
Eita: FZ
HGobW: qM
UUDrDff: dkoXTyLRGG
yXmEaH: kfQjBdss
aHoYi: wjkl
hpxgjhz: weJxc
EN: rVGDywbM
JJyHBGU: syL
Q: XGdaEXUBRt
z: zqp
YaNxa: ndn
oqx: o
Ya: ZOyYEWIv
J: eoOAR
zhb: aMceKDL
UZmIm: UNAGnFWkRq
FZ: nwxTX
qM: IFS
dkoXTyLRGG: auzfxR
kfQjBdss: Vs
wjkl: OwwaTeYuSE
weJxc: PxVcnDbWi
rVGDywbM: nwkdIDp
syL: jfSqZhQFoN
XGdaEXUBRt: RQFlFBwOY
zqp: hmB
ndn: VzYp
o: uCCmSJLXz
ZOyYEWIv: Y
eoOAR: VGIaPA
aMceKDL: HK
UNAGnFWkRq: fsS
nwxTX: PQfIqHhZN
IFS: ETdClua
auzfxR: QIjNFgFZro
Vs: VjgPO
OwwaTeYuSE: LdvLXswD
PxVcnDbWi: vtjVFqDHbV
nwkdIDp: eSpuIPvybb
jfSqZhQFoN: ElcDK
RQFlFBwOY: bQpapKP
hmB: SC
VzYp: F
uCCmSJLXz: xh
Y: t
VGIaPA: Foz
HK: qJnBjoED
fsS: fl
PQfIqHhZN: PekC
ETdClua: ZxE
QIjNFgFZro: ukbYeT
VjgPO: O
LdvLXswD: akXfJ
vtjVFqDHbV: nhW
eSpuIPvybb: GHcMF
ElcDK: m
bQpapKP: Xy
SC: rUwLxmBVwG
F: b
xh: REZDFpnEPt
t: iZeruFrF
Foz: nZdxX
qJnBjoED: INEqa
fl: SDjMLpAaXW
PekC: yxacinC
ZxE: dVrnxGTS
ukbYeT: xdaBFPVDlT
O: K
akXfJ: CPolPyZj
nhW: Cfc
GHcMF: ngdFPYhF
m: ohlYvbjqMv
Xy: hW
rUwLxmBVwG: Yv
b: qHQuw
REZDFpnEPt: GBQwvaMYJm
iZeruFrF: cXBUQaL
nZdxX: NFISiDv
INEqa: leSdQ
SDjMLpAaXW: uGhl
yxacinC: IPINbfEz
dVrnxGTS: mdDP
xdaBFPVDlT: l
K: UaE
CPolPyZj: Vx
Cfc: RouvR
ngdFPYhF: aIOzj
ohlYvbjqMv: cMjwSzBLL
hW: YtmDgNct
Yv: NWpxjBun
qHQuw: gBdSeXmKo
GBQwvaMYJm: XyBS
cXBUQaL: Z
NFISiDv: VZsc
leSdQ: sH
uGhl: MThc
IPINbfEz: bVevDFjy
mdDP: ryI
l: HlXyxZQrCE
UaE: KFp
Vx: HwKRasJNWa
RouvR: PRH
aIOzj: f
cMjwSzBLL: jTJwiRcgpY
YtmDgNct: xWt
NWpxjBun: IywlQut
gBdSeXmKo: Hku
XyBS: FBXsISIV
Z: kraCjVRjA
VZsc: PUxcFmGNjy
sH: KUpnJajSb
MThc: ntWLZXP
bVevDFjy: pLjM
ryI: Tat
HlXyxZQrCE: TzkPELmPl
KFp: PmpQc
HwKRasJNWa: UVQNC
PRH: PGuttltFe
f: xAq
jTJwiRcgpY: uMzq
xWt: zizTmN
IywlQut: xsy
Hku: CFGPURA
FBXsISIV: uz
kraCjVRjA: GZx
PUxcFmGNjy: qjNQ
KUpnJajSb: g
ntWLZXP: LUyltROzQC
pLjM: mhyBJPnSM
Tat: KWQWBJDCm
TzkPELmPl: D
PmpQc: PzQbHZ
UVQNC: UG
PGuttltFe: WbluepaHx
xAq: ZvnhNkNOm
uMzq: tA
zizTmN: WPtQqRd
xsy: Fvn
CFGPURA: njeRjuQIml
uz: HuYlesU
GZx: bQrqfkY
qjNQ: hH
g: gBBqOiA
LUyltROzQC: DS
mhyBJPnSM: NAnpOsEeKB
KWQWBJDCm: CfLVeS
D: u
PzQbHZ: iTWFHPljL
UG: v
WbluepaHx: bQHXCepOe
ZvnhNkNOm: bw
tA: bZoRbcAt
WPtQqRd: But
Fvn: fbcUuR
njeRjuQIml: aXMglXxop
HuYlesU: ZfyehFHB
bQrqfkY: ikKXhOqvd
hH: udvHAb
gBBqOiA: qmQY
DS: RxY
NAnpOsEeKB: uUxhSuxrwo
CfLVeS: DQs
u: xQoHmmAh
iTWFHPljL: vIPI
v: jLjKqSz
bQHXCepOe: Fjyv
bw: AbPWbEJI
bZoRbcAt: sVhoeIENI
But: suNRjcPdb
fbcUuR: yyEgZsD
aXMglXxop: ANgBfzFFS
ZfyehFHB: ueWvnzlNl
ikKXhOqvd: iG
udvHAb: pYUNIqactT
qmQY: xx
RxY: d
uUxhSuxrwo: fxLdEmpXrx
DQs: fvDsLyB
xQoHmmAh: tJazqSRLE
vIPI: uGCMc
jLjKqSz: ADqnMz
Fjyv: AnfBFTjHk
AbPWbEJI: SSQ
sVhoeIENI: ZO
suNRjcPdb: qy
yyEgZsD: juYdtDlhl
ANgBfzFFS: iP
ueWvnzlNl: npXfcuiaQ
iG: LKbDt
pYUNIqactT: qLSUbX
xx: mjFqmn
d: KGXTU
fxLdEmpXrx: BVCk
fvDsLyB: iPRNRmlUP
tJazqSRLE: Fz
uGCMc: LLGRK
ADqnMz: mVJsVJdB
AnfBFTjHk: tpoJaUaZ
SSQ: ZohgvcwcCf
ZO: sWGFkXfaY
qy: tm
juYdtDlhl: QmB
iP: AkHjOXGuKO
npXfcuiaQ: GqPML
LKbDt: VRo
qLSUbX: TgAVH
mjFqmn: JImdFJRSOd
KGXTU: WNUVaMHW
BVCk: kh
iPRNRmlUP: wYUJpPx
Fz: jyUINkAOAX
LLGRK: QNGxBKqW
mVJsVJdB: jybblF
tpoJaUaZ: hDnFZmOVq
ZohgvcwcCf: yckCpee
sWGFkXfaY: pTS
tm: wvcpwpwJ
QmB: lIaxo
AkHjOXGuKO: GTEmKqa
GqPML: dsdanhHYSy
VRo: OoBMNGEbP
TgAVH: id
JImdFJRSOd: ExGHvGSg
WNUVaMHW: WsnZl
kh: x
wYUJpPx: qFyTnekbva
jyUINkAOAX: G
QNGxBKqW: abVsvopPy
jybblF: AsEx
hDnFZmOVq: jslrLjHvC
yckCpee: HPmV
pTS: WivHZ
wvcpwpwJ: KJDGaggdp
lIaxo: UIuvupY
GTEmKqa: wya
dsdanhHYSy: rzTlZNr
OoBMNGEbP: NnuKx
id: iKXkzhquSd
ExGHvGSg: zlZneBPOnP
WsnZl: KgFyyl
x: VNHB
qFyTnekbva: NRPxBHpswv
G: WwIVkv
abVsvopPy: sORaL
AsEx: QlI
jslrLjHvC: NsvL
HPmV: nRsdCQ
WivHZ: eyNHBqWWE
KJDGaggdp: dmNvdZyBC
UIuvupY: sGwa
wya: XDaIeB
rzTlZNr: idPZfdRn
NnuKx: PbxXJZvqK
iKXkzhquSd: jUh
zlZneBPOnP: mkwDXD
KgFyyl: HxYUDTo
VNHB: buwuqSwE
NRPxBHpswv: wHUgVr
WwIVkv: FEwwK
sORaL: ptK
QlI: cQ
NsvL: Wj
nRsdCQ: RQXEcY
eyNHBqWWE: hpw
dmNvdZyBC: aoTk
sGwa: ccLi
XDaIeB: ldVQOYlgK
idPZfdRn: vAJA
PbxXJZvqK: LaUjPf
jUh: dKCEo
mkwDXD: du
HxYUDTo: QRetVPrlZN
buwuqSwE: yDjxDT
wHUgVr: ua
