ENCODE
gCKRcYDYNU: DEaacew OZtS tJpBcYLCp vGKAI
vGKAI: EdBpC
tJpBcYLCp: AnWxQyR
OZtS: A
DEaacew: okxFqPNm
EdBpC: Onh
AnWxQyR: DFxlZOQEw
A: buiXTxdk
okxFqPNm: guU
Onh: JdDzyMfrj
DFxlZOQEw: YZ
buiXTxdk: QiCeYqz
guU: mgbTOFUf
JdDzyMfrj: yWpMC
YZ: Epbvj
QiCeYqz: FrcyGOgbK
mgbTOFUf: de
yWpMC: ToLBqHBtkD
Epbvj: kHK
FrcyGOgbK: heGqdZ
de: tJprl
ToLBqHBtkD: xCcYeVT
kHK: BZu
heGqdZ: OlBIOY
tJprl: MsXtK
xCcYeVT: hIz
BZu: IEkGw
OlBIOY: RSg
MsXtK: qosC
hIz: LFtVCId
IEkGw: SkrAbEq
RSg: XgXyCwPJye
qosC: L
LFtVCId: LMrVHhVhyt
SkrAbEq: Ni
XgXyCwPJye: AJoeOSe
L: ILdXNr
LMrVHhVhyt: Aubam
Ni: Qs
AJoeOSe: j
ILdXNr: NJSowu
Aubam: KYmrzoz
Qs: TsdNFZJJuR
j: q
NJSowu: VIgcsL
KYmrzoz: GZIBvY
TsdNFZJJuR: NgNM
q: YykzPudN
VIgcsL: bZYqH
GZIBvY: oHeyH
NgNM: ZGzJeJ
YykzPudN: yVxD
bZYqH: oQQ
oHeyH: zIb
ZGzJeJ: mTF
yVxD: cotRmJCwPE
oQQ: xtdYrwU
zIb: ysNWwQhfn
mTF: TjTxHgyvoR
cotRmJCwPE: RotITNzBoj
xtdYrwU: zsIZrFiuE
ysNWwQhfn: RNnfp
TjTxHgyvoR: OMocxTDE
RotITNzBoj: DdJLPewn
zsIZrFiuE: YNug
RNnfp: HwQTmzFql
OMocxTDE: E
DdJLPewn: lf
YNug: byPAwJePf
HwQTmzFql: HvcSlA
E: CAA
lf: yUe
byPAwJePf: VkxzjmIc
HvcSlA: sp
CAA: ais
yUe: oBLBgyWzXp
VkxzjmIc: lTmNJ
sp: ZZnf
ais: ECyrIfoWp
oBLBgyWzXp: qDEzTAQbK
lTmNJ: CxUJhGd
ZZnf: MrJscx
ECyrIfoWp: iMbpeMc
qDEzTAQbK: pEwVhqu
CxUJhGd: gIbl
MrJscx: ICCj
iMbpeMc: kOkzGcMn
pEwVhqu: ded
gIbl: iLfvBr
ICCj: qrLxLNDi
kOkzGcMn: qgVRggLyNG
ded: DgogxhZLie
iLfvBr: dOJwOQYi
qrLxLNDi: pBZgbb
qgVRggLyNG: EGuvT
DgogxhZLie: rDE
dOJwOQYi: QLBnCZxpk
pBZgbb: y
EGuvT: HrMTiuf
rDE: BZwRyGiyr
QLBnCZxpk: eVThWPQEvL
y: ELnWCrgDU
HrMTiuf: ZtC
BZwRyGiyr: GkHhM
eVThWPQEvL: LGPgFKE
ELnWCrgDU: UPGbznyl
ZtC: rhqTV
GkHhM: LKlaea
LGPgFKE: lOwqqfah
UPGbznyl: pv
rhqTV: TivN
LKlaea: XoRU
lOwqqfah: Mww
pv: hsxKhE
TivN: gBLQFyCNbl
XoRU: dDQW
Mww: UNhcwCg
hsxKhE: kLQovHfphh
gBLQFyCNbl: uDJDFK
dDQW: KhMfh
UNhcwCg: ofmEuFL
kLQovHfphh: JKNWyckc
uDJDFK: QuZxgFSIqM
KhMfh: GT
ofmEuFL: IVKdewBiW
JKNWyckc: ge
QuZxgFSIqM: VxwlPJrJ
GT: EYbkZe
IVKdewBiW: oBMIEBhP
ge: R
VxwlPJrJ: wOAaXSQbwi
EYbkZe: Bzuj
oBMIEBhP: CxOWGVOL
R: xuy
wOAaXSQbwi: Kfp
Bzuj: zmBQbV
CxOWGVOL: uV
xuy: cucI
Kfp: KwWqYIW
zmBQbV: df
uV: PqQ
cucI: jaMTLHOYi
KwWqYIW: jgWKAB
df: C
PqQ: ksSbocoofZ
jaMTLHOYi: oUI
jgWKAB: RdLD
C: ciB
ksSbocoofZ: HB
oUI: zKLqoxnKlk
RdLD: r
ciB: NL
HB: otX
zKLqoxnKlk: wAKAlb
r: sesqcToXR
NL: SZdCPgx
otX: IVOIHd
wAKAlb: uGMyUU
sesqcToXR: UKAqPn
SZdCPgx: LPLhOxD
IVOIHd: eYcM
uGMyUU: at
UKAqPn: RjomBpPEf
LPLhOxD: AfUSpsmne
eYcM: BEdo
at: uGa
RjomBpPEf: Ge
AfUSpsmne: PPbYmUTKcQ
BEdo: n
uGa: xu
Ge: vCxe
PPbYmUTKcQ: lZouBkah
n: kPbvelwWHT
xu: YMZj
vCxe: uu
lZouBkah: Ah
kPbvelwWHT: gOwQJYMO
YMZj: uTLDKAV
uu: NJHYNFmavr
Ah: XSRW
gOwQJYMO: rv
uTLDKAV: Xh
NJHYNFmavr: i
XSRW: XKB
rv: Adgms
Xh: uhMjpp
i: hJLPyPvav
XKB: DsOobwyFT
Adgms: FPpLvy
uhMjpp: PEy
hJLPyPvav: evfpSVGbgG
DsOobwyFT: OpUuqBYX
FPpLvy: jEjFe
PEy: WYRm
evfpSVGbgG: jzTbe
OpUuqBYX: AfDHlW
jEjFe: KTmHbZdL
WYRm: YdzjeoIrav
jzTbe: bBqgqHOv
AfDHlW: nt
KTmHbZdL: PKrcgt
YdzjeoIrav: N
bBqgqHOv: sBrfdY
nt: Vhk
PKrcgt: nhvkVg
N: ibk
sBrfdY: tTaQVY
Vhk: jTbC
nhvkVg: lhQZVq
ibk: rDVadNN
tTaQVY: apWWNR
jTbC: hnHQvC
lhQZVq: Ucab
rDVadNN: DA
apWWNR: T
hnHQvC: aJDQswnVJe
Ucab: txZGphoSuo
DA: eECrZIqV
T: qfpwhb
aJDQswnVJe: PSaznK
txZGphoSuo: rmI
eECrZIqV: nmCpxEFJ
qfpwhb: iUjqFud
PSaznK: gyJwUSDIMT
rmI: PIjaaBtUb
nmCpxEFJ: PfXuo
iUjqFud: yafZeIFrhd
gyJwUSDIMT: EjV
PIjaaBtUb: lUmvW
PfXuo: axsnhVNU
yafZeIFrhd: eZs
EjV: Hz
lUmvW: qyLVs
axsnhVNU: GJLVsAyK
eZs: vMwgd
Hz: qeVnQJS
qyLVs: HsXLw
GJLVsAyK: rGGJsVsK
vMwgd: lYpw
qeVnQJS: NuOi
HsXLw: MNyc
rGGJsVsK: TbADE
lYpw: jHGld
NuOi: mRgZjkX
MNyc: gEsCVIiQmk
TbADE: UaVY
jHGld: gKp
mRgZjkX: ZcnEqPqB
gEsCVIiQmk: nS
UaVY: dZIpBJdBr
gKp: OkqGXX
ZcnEqPqB: S
nS: GHkevTl
dZIpBJdBr: lQ
OkqGXX: ouKaqvVaaC
S: OFb
GHkevTl: WjNV
lQ: ETKrch
ouKaqvVaaC: RWzx
OFb: itLmO
WjNV: FaR
ETKrch: zrdLxehMYT
RWzx: RhKD
itLmO: lxchI
FaR: mPfeUlCCfx
zrdLxehMYT: MwhDjhrF
RhKD: gMK
lxchI: laZDreQme
mPfeUlCCfx: hPkBc
MwhDjhrF: VP
gMK: HEHuuqP
laZDreQme: sRTFaIiD
hPkBc: tflQEVjq
VP: LzXppsUm
HEHuuqP: BDmjq
sRTFaIiD: cep
tflQEVjq: MoNqHDU
LzXppsUm: xe
BDmjq: IpBHXhUN
cep: LfKfqWcNGa
MoNqHDU: NlB
xe: BSyiNUb
IpBHXhUN: oTWuzwwApJ
LfKfqWcNGa: VV
NlB: TcBaM
BSyiNUb: Ott
oTWuzwwApJ: UTnRd
VV: fHxPlbZV
TcBaM: WbKqMP
Ott: TmwJX
UTnRd: cZwQ
fHxPlbZV: XlVNdjjvL
WbKqMP: BHCvVW
TmwJX: zrH
cZwQ: GsIboYjBX
XlVNdjjvL: xbiGGQnMB
BHCvVW: TsgrwWSflJ
zrH: lXYOLyxAG
GsIboYjBX: jNINcwN
xbiGGQnMB: FN
TsgrwWSflJ: lmeoHmXnUW
lXYOLyxAG: HJ
jNINcwN: mcWKljjnxE
FN: xpeN
lmeoHmXnUW: SjyPvdLL
HJ: ddvB
mcWKljjnxE: eZmZrardn
xpeN: JIHYHodV
SjyPvdLL: ImeoB
ddvB: nKCaaLlZv
eZmZrardn: aoZIm
JIHYHodV: dKbQrDGiZd
ImeoB: Pp
nKCaaLlZv: eBMfGS
aoZIm: k
dKbQrDGiZd: zSFEORcHB
Pp: BKocuMak
eBMfGS: WfZG
k: toVnXjVeH
zSFEORcHB: hwdr
BKocuMak: OHrBTLwGTq
WfZG: Lxe
toVnXjVeH: rEGGA
hwdr: mlD
OHrBTLwGTq: NqUlfVOeh
Lxe: lqMw
rEGGA: WSrwV
mlD: fa
NqUlfVOeh: Q
lqMw: iPfuJ
WSrwV: hreDdSt
fa: BxOvtmbt
Q: fZUzlhPaE
iPfuJ: SrLeTRl
hreDdSt: iRVXb
BxOvtmbt: KihegLmJv
fZUzlhPaE: zmtktx
SrLeTRl: faknGLxw
iRVXb: zSiaOfP
KihegLmJv: MHWwmciA
zmtktx: AGkySClaV
faknGLxw: zK
zSiaOfP: QtW
MHWwmciA: o
AGkySClaV: mUGKX
zK: TcfpdyAuV
QtW: iGI
o: exibXPioCN
mUGKX: ZaKjRQ
TcfpdyAuV: aGLCiOIRLr
iGI: dQE
exibXPioCN: qjMIbHdBZ
ZaKjRQ: bnsn
aGLCiOIRLr: jK
dQE: ETRtJmVHSI
qjMIbHdBZ: lwSyzpfeTa
bnsn: w
jK: XWapHKza
ETRtJmVHSI: hkZrr
lwSyzpfeTa: Y
w: jncu
XWapHKza: pOmmQAcfI
hkZrr: AHRxh
Y: Wiu
jncu: ZV
pOmmQAcfI: sfx
AHRxh: hdIZ
Wiu: zoztSiKHV
ZV: wnaVtADq
sfx: CNUbPst
hdIZ: dJueF
zoztSiKHV: dyw
wnaVtADq: sj
CNUbPst: F
dJueF: Twls
dyw: Rlqh
sj: kDBkgo
F: udIYfL
Twls: t
Rlqh: GzTQuLNTCs
kDBkgo: O
udIYfL: RnhVjT
t: bkArejXd
GzTQuLNTCs: jX
O: DG
RnhVjT: czekZ
bkArejXd: m
jX: ZmJvfAnCJ
DG: TVZLPnTxLP
czekZ: xDJmo
m: yXOswbR
ZmJvfAnCJ: RGHXt
TVZLPnTxLP: HXJ
xDJmo: SWaw
yXOswbR: b
RGHXt: iJuReiSf
HXJ: PQJrWMSP
SWaw: yRrvoGiZQ
b: iWBqrDA
iJuReiSf: uEEn
PQJrWMSP: UpO
yRrvoGiZQ: bsVwKJABH
iWBqrDA: hHe
uEEn: Bjl
UpO: K
bsVwKJABH: iAngov
hHe: cUAFFEI
Bjl: JHz
K: Uxy
iAngov: fHPaNiaQ
cUAFFEI: aR
JHz: eu
Uxy: wi
fHPaNiaQ: NMzxnx
aR: xOjyE
eu: cJsnfq
wi: rxQCA
NMzxnx: WqxOkL
xOjyE: QUZD
cJsnfq: WsjxfvrqR
rxQCA: l
WqxOkL: ytQbifmt
QUZD: nv
WsjxfvrqR: jGOdJLR
l: WyNhSW
ytQbifmt: md
nv: awfJsDy
jGOdJLR: dpShilDpNZ
WyNhSW: zAyPojAsd
md: Z
awfJsDy: bmVOQr
dpShilDpNZ: EvA
zAyPojAsd: MtEd
Z: UhJudCdp
bmVOQr: ftwFUUcXWe
EvA: ZQJq
MtEd: uNcKXkD
UhJudCdp: bJcW
ftwFUUcXWe: dziX
ZQJq: AC
uNcKXkD: AiSx
bJcW: vyCrJRQnWp
dziX: fRRvrC
AC: UiVUT
AiSx: hsxOl
vyCrJRQnWp: CRACQrX
fRRvrC: zcECTMcR
UiVUT: OTCvveQ
hsxOl: kXHjYyQJwO
CRACQrX: KdfxIKtGd
zcECTMcR: BBBn
OTCvveQ: DIJyziF
kXHjYyQJwO: xwCPF
KdfxIKtGd: GIfF
BBBn: gxbR
DIJyziF: IxSQSVvYuY
xwCPF: XysMG
GIfF: LLqAIqPLay
gxbR: dZjzBDUi
IxSQSVvYuY: eoHAzEmnwr
XysMG: qJQjUt
LLqAIqPLay: CG
dZjzBDUi: iiyZyRTImD
eoHAzEmnwr: M
qJQjUt: kVgCL
CG: WCLYjgzvnC
iiyZyRTImD: JkHFoIHfQ
M: osaBUrstL
kVgCL: oTLtiCzZLW
WCLYjgzvnC: svgAz
JkHFoIHfQ: sjFfLkieH
osaBUrstL: axLJjhPB
oTLtiCzZLW: aj
svgAz: kPJbYiA
sjFfLkieH: vidMjiuv
axLJjhPB: YmeXAVWT
aj: bhRgVNZPjg
kPJbYiA: UmyBykZQMT
vidMjiuv: lK
YmeXAVWT: UNwdtPaG
bhRgVNZPjg: RQbDHhx
UmyBykZQMT: nKR
lK: kDYx
UNwdtPaG: v
RQbDHhx: rrfVabNo
nKR: lHc
kDYx: X
v: JzqjKxe
rrfVabNo: MSrNJiXu
lHc: JMAcFXu
X: LjB
JzqjKxe: OuQwLOA
MSrNJiXu: ULKHdOTa
JMAcFXu: quFRmPz
LjB: uAjSX
OuQwLOA: Dasmp
ULKHdOTa: uBEH
quFRmPz: rUTczHu
uAjSX: zSNFAqOlQd
Dasmp: XJxCFbO
uBEH: FMqlIvzuIr
rUTczHu: mJTTP
zSNFAqOlQd: Vi
XJxCFbO: AVMqLuC
FMqlIvzuIr: eQSUd
mJTTP: NByb
Vi: Aj
AVMqLuC: vKHDE
eQSUd: V
NByb: bwVU
Aj: e
vKHDE: VxscemQXU
V: rfgtsXTHlN
bwVU: uXzGd
e: tAwdrsviEM
VxscemQXU: HG
rfgtsXTHlN: QRBmF
uXzGd: CzYoy
tAwdrsviEM: zxchGnVV
HG: c
QRBmF: XETo
CzYoy: aXoSfVr
zxchGnVV: CDzn
c: NRcRnNPag
XETo: XnlQoUsQu
aXoSfVr: zDFjgAtRsp
CDzn: tSJmRTSPFu
NRcRnNPag: rKSsnVRb
XnlQoUsQu: tLuOC
zDFjgAtRsp: TimROHsuB
tSJmRTSPFu: qfXPcbwle
rKSsnVRb: UnYOmZNxd
tLuOC: imtcTBZPmr
TimROHsuB: nSgsvKXu
qfXPcbwle: UOsDkQARBs
UnYOmZNxd: OmMJ
imtcTBZPmr: DOxrEOAOl
nSgsvKXu: PPUz
UOsDkQARBs: gprNpzT
OmMJ: VLEMCJA
DOxrEOAOl: RUOcbHXSfR
PPUz: YuYlYZW
gprNpzT: EZhyYyKOR
VLEMCJA: jackB
RUOcbHXSfR: Tqa
YuYlYZW: QrHaRZLe
EZhyYyKOR: x
jackB: G
Tqa: zNBG
QrHaRZLe: GO
x: oczd
G: fNS
zNBG: PsptsRGXEN
GO: DJnSW
oczd: guofrIBaAF
fNS: QZbhP
PsptsRGXEN: iagG
DJnSW: ZApknA
guofrIBaAF: WOf
QZbhP: uUcg
iagG: hTgY
ZApknA: RRJHlVl
WOf: VA
uUcg: tFAFgqXegm
hTgY: IH
RRJHlVl: krwyfIoAP
VA: YqiTn
tFAFgqXegm: oSKce
IH: hmXSU
krwyfIoAP: ZY
YqiTn: urvOQNxHWT
oSKce: aBTWZCFMc
hmXSU: tlFkGyEW
ZY: Ow
urvOQNxHWT: OPd
aBTWZCFMc: YnnDLazfT
tlFkGyEW: PCbfTRiU
Ow: WwLw
OPd: nQb
YnnDLazfT: VKoUC
PCbfTRiU: Kna
WwLw: ZVq
nQb: Yn
VKoUC: TAS
Kna: AmEPKkQnKW
ZVq: Wjzii
Yn: pUMpPGxyKL
TAS: vhY
AmEPKkQnKW: eBjDKwktft
Wjzii: TShgw
pUMpPGxyKL: JlJLRnwFv
vhY: jrJYFa
eBjDKwktft: pzzge
TShgw: grJsLanJt
JlJLRnwFv: MZM
jrJYFa: xmuYqq
