ENCODE
HnKATfl: ZUPjNAVl jVn awKcVdgjv Nmx HeF A NAkO iOfR iL hGQocIv UBmkznasb LrNJjnaW CowIFOYvUp PKGaix gYDzOCKnMZ oQVPGNZD W
jVn: jyWe
awKcVdgjv: gUecHd
Nmx: WEmMoXLpg
NAkO: puRG
iOfR: YPATwRfm
iL: xXWWS
hGQocIv: kKhe
UBmkznasb: cym
LrNJjnaW: JqzwSYwuAG
CowIFOYvUp: YjXiqNep
gYDzOCKnMZ: ASfIhPKZ
oQVPGNZD: PzBTmZ
HeF: spEABSL
ZUPjNAVl: daPEF
A: lggm
PKGaix: UqkLIZH
W: KcqNLpQq
jyWe: JkNCwEPz
gUecHd: FImTkFPz
WEmMoXLpg: SlOR
puRG: cTGIZaZW
YPATwRfm: DsCO
xXWWS: jBiUFPAt
kKhe: KTmHJtra
cym: XGm
JqzwSYwuAG: LTtDtGc
YjXiqNep: TYtlZOFH
ASfIhPKZ: HCAi
PzBTmZ: KFL
spEABSL: j
daPEF: fzk
lggm: q
UqkLIZH: ijnGfhlY
KcqNLpQq: FVMaXHp
JkNCwEPz: XE
FImTkFPz: lrzxnZtp
SlOR: ko
cTGIZaZW: sGNDVFLdp
DsCO: Fiy
jBiUFPAt: BGgq
KTmHJtra: bYDWdR
XGm: wcE
LTtDtGc: ZghRo
TYtlZOFH: fpujvgGxRD
HCAi: XsbLMiLF
KFL: uSUyPpfrUi
j: HMxspIW
fzk: Fpm
q: sULC
ijnGfhlY: xTPXVBieD
FVMaXHp: jto
XE: UBDcyoeDH
lrzxnZtp: BihFydPYiB
ko: GLa
sGNDVFLdp: abfufdtdTX
Fiy: Tjz
BGgq: GQwwV
bYDWdR: XRva
wcE: pwOm
ZghRo: knpb
fpujvgGxRD: bXjt
XsbLMiLF: ZSbuWLNbr
uSUyPpfrUi: ROgNnscWt
HMxspIW: JN
Fpm: EQ
sULC: fV
xTPXVBieD: fnEAlo
jto: GsJQU
UBDcyoeDH: shMqjQet
BihFydPYiB: UUCGESPeCY
GLa: zBa
abfufdtdTX: XTCoRGR
Tjz: ZwkCmTYOav
GQwwV: JNNTB
XRva: MfZvbhHw
pwOm: SEMIZ
knpb: ina
bXjt: srTuR
ZSbuWLNbr: ENioS
ROgNnscWt: GAME
JN: UHEVW
EQ: XUDxNJnkes
fV: zLvsKe
fnEAlo: Tu
GsJQU: YlAQFo
shMqjQet: HnzkcEonl
UUCGESPeCY: oeiaNx
zBa: kqPKKFb
XTCoRGR: y
ZwkCmTYOav: el
JNNTB: eDiPpfcRfz
MfZvbhHw: bfacKj
SEMIZ: gcw
ina: ZbQk
srTuR: lmM
ENioS: zRype
GAME: Sm
UHEVW: HU
XUDxNJnkes: cde
zLvsKe: HnZ
Tu: qrtiZ
YlAQFo: xEC
HnzkcEonl: WxXqrF
oeiaNx: jOmkGBMRuf
kqPKKFb: PMdJko
y: fxfMNqI
el: zlLdadDzMB
eDiPpfcRfz: oLA
bfacKj: fNJnxPrfLJ
gcw: deORzW
ZbQk: qlinjEc
lmM: R
zRype: GzfHZuqzu
Sm: adxgsWeU
HU: xaFLsOoV
cde: JtRplZ
HnZ: dt
qrtiZ: uqgReHx
xEC: mCFaVHqx
WxXqrF: QW
jOmkGBMRuf: qbnvBz
PMdJko: kqgN
fxfMNqI: cGSZl
zlLdadDzMB: h
oLA: PdjuVwhILT
fNJnxPrfLJ: xynn
deORzW: HB
qlinjEc: XSIRYBX
R: WGrzi
GzfHZuqzu: kv
adxgsWeU: xjbdkabdQp
xaFLsOoV: XLPL
JtRplZ: cLCM
dt: uPCwjakXD
uqgReHx: yZCbErc
mCFaVHqx: HZifJimT
QW: QZJYXbqtj
qbnvBz: ebi
kqgN: AYUtYNO
cGSZl: tqjXScWzTP
h: rE
PdjuVwhILT: RZp
xynn: GVhxxRQkO
HB: Ggq
XSIRYBX: LfL
WGrzi: QeHzTWEe
kv: eqtnX
xjbdkabdQp: FEBbBY
XLPL: kao
cLCM: WevAx
uPCwjakXD: vBihk
yZCbErc: MypLp
HZifJimT: PeFPmn
QZJYXbqtj: WnkKAe
ebi: QVlEhAgl
AYUtYNO: UHsbzQu
tqjXScWzTP: PdzXrhFA
rE: i
RZp: yTDFW
GVhxxRQkO: ZSW
Ggq: XigQJzuL
LfL: lUj
QeHzTWEe: Kx
eqtnX: yhs
FEBbBY: CIZgjrPF
kao: KbPJK
WevAx: U
vBihk: MismW
MypLp: toZybYKFd
PeFPmn: cxVF
WnkKAe: IuSwUHMWlo
QVlEhAgl: ebmbgvV
UHsbzQu: GEdl
PdzXrhFA: DlfgbuA
i: QOVgpRI
yTDFW: AeeE
ZSW: gedQjDJVJW
XigQJzuL: N
lUj: BQW
Kx: MazMw
yhs: IIuUVhtTS
CIZgjrPF: rKdsbhxn
KbPJK: dyBUx
U: jE
MismW: pOFYYDkHfT
toZybYKFd: GwAsPiw
cxVF: xWNJ
IuSwUHMWlo: NCbiliva
ebmbgvV: ELjqOVuC
GEdl: GQ
DlfgbuA: cYioDo
QOVgpRI: JL
AeeE: vN
gedQjDJVJW: StejHmpy
N: ZtvbaLy
BQW: kRjI
MazMw: owuy
IIuUVhtTS: guCXvTqm
rKdsbhxn: RujwDKqZR
dyBUx: ntCCItIoQ
jE: Ygmpy
pOFYYDkHfT: iPrP
GwAsPiw: B
xWNJ: vzUYj
NCbiliva: KxsVgfG
ELjqOVuC: a
GQ: gtGR
cYioDo: nx
JL: kQWGzbwGO
vN: zvbtNaWT
StejHmpy: TOieTBdR
ZtvbaLy: IODGnlwJ
kRjI: uo
owuy: CDSHSMF
guCXvTqm: DLQYvwKHyh
RujwDKqZR: MzHA
ntCCItIoQ: tivgcRIsr
Ygmpy: pLqq
iPrP: OPftNJhHhW
B: gOlryoM
vzUYj: tRdrDyhRD
KxsVgfG: nS
a: iTTz
gtGR: ver
nx: QOsfCk
kQWGzbwGO: WSZCYERx
zvbtNaWT: ScifHS
TOieTBdR: XOi
IODGnlwJ: OnVMj
uo: Iv
CDSHSMF: SWdZYhF
DLQYvwKHyh: boeIm
MzHA: BidiJgXU
tivgcRIsr: BdqGy
pLqq: zvn
OPftNJhHhW: WRcSV
gOlryoM: ji
tRdrDyhRD: er
nS: rxLNJRqRM
iTTz: npd
ver: sDm
QOsfCk: HrSc
WSZCYERx: OMZE
ScifHS: Ul
XOi: cCnFfXCAL
OnVMj: jYZ
Iv: TQLZWcvf
SWdZYhF: iFTJgg
boeIm: IhI
BidiJgXU: MkHQ
BdqGy: kPHwfDRiOm
zvn: mkXL
WRcSV: rxcoerVXZ
ji: qEN
er: SL
rxLNJRqRM: kEt
npd: xkNNbmw
sDm: Lnqw
HrSc: cfORAB
OMZE: VEOorl
Ul: YXYyoqC
cCnFfXCAL: NPY
jYZ: zaNIMUNLk
TQLZWcvf: jLFwStfGB
iFTJgg: sxIm
IhI: MxwATdecI
MkHQ: EKsJdQmf
kPHwfDRiOm: k
mkXL: ZCWLTQuwnI
rxcoerVXZ: yqMyeV
qEN: p
SL: olOQ
kEt: mZPfsePaDD
xkNNbmw: Wk
Lnqw: ZcaxSwUPGc
cfORAB: aPZzs
VEOorl: IGpTcW
YXYyoqC: ZUOpmyJJEt
NPY: CEgAhmpw
zaNIMUNLk: UKOsEuJ
jLFwStfGB: AQc
sxIm: ADOKXcgTN
MxwATdecI: vhedUxpJZ
EKsJdQmf: XLRkutDF
k: z
ZCWLTQuwnI: RWxqaNyzdn
yqMyeV: yWMtDS
p: HGglUVKEK
olOQ: kyRKzLxFNM
mZPfsePaDD: J
Wk: erbWZwFEYx
ZcaxSwUPGc: HYVZqhNtU
aPZzs: WEgSS
IGpTcW: BYcCf
ZUOpmyJJEt: DKdPXQABra
CEgAhmpw: jzuzK
UKOsEuJ: opYb
AQc: mxlreH
ADOKXcgTN: bLj
vhedUxpJZ: NTlXk
XLRkutDF: kQ
z: qO
RWxqaNyzdn: qRsF
yWMtDS: fVJaEtv
HGglUVKEK: hTeVBSNgoE
kyRKzLxFNM: JtDrLg
J: tBXHJTp
erbWZwFEYx: TiU
HYVZqhNtU: CYRu
WEgSS: o
BYcCf: aJTcokWFT
DKdPXQABra: gLAB
jzuzK: KiMdM
opYb: OkdRWSmcpO
mxlreH: DcVmVgV
bLj: CyMMdvUk
NTlXk: vaIA
kQ: wrEi
qO: tkv
qRsF: KCZSm
fVJaEtv: XurX
hTeVBSNgoE: w
JtDrLg: zxojACN
tBXHJTp: cyEVgt
TiU: XG
CYRu: IFryAwhBzF
o: JrtnSyao
aJTcokWFT: HpnzSLP
gLAB: eilVoCYRz
KiMdM: zFY
OkdRWSmcpO: tPetZABCfN
DcVmVgV: ZRDwfIw
CyMMdvUk: kyeQmon
vaIA: YvNv
wrEi: LHvXGfkzT
tkv: VRilP
KCZSm: JUoeLknS
XurX: F
w: LAX
zxojACN: fMEhKqsBq
cyEVgt: nVFPTRtBmz
XG: zMWyYAE
IFryAwhBzF: zGyFqyKh
JrtnSyao: t
HpnzSLP: YkALLyuh
eilVoCYRz: ULODBexi
zFY: fxzMXIzDZ
tPetZABCfN: XkknalSyJw
ZRDwfIw: cJz
kyeQmon: xPItGe
YvNv: SRGQNxfEz
LHvXGfkzT: O
VRilP: Zh
JUoeLknS: Xel
F: CgfMsS
LAX: TDn
fMEhKqsBq: tGbwL
nVFPTRtBmz: VNzs
zMWyYAE: HxGLU
zGyFqyKh: jlxbYT
t: Ug
YkALLyuh: ie
ULODBexi: NaEB
fxzMXIzDZ: ZIFaEsg
XkknalSyJw: vGKHlfBBdN
cJz: RvkKL
xPItGe: b
SRGQNxfEz: hyddlD
O: nRxi
Zh: YqpLt
Xel: NfXuQdf
CgfMsS: gsJYPjn
TDn: nCpdCI
tGbwL: gboRiN
VNzs: NNc
HxGLU: TE
jlxbYT: kRH
Ug: K
ie: lBSHXVId
NaEB: bkcFWAh
ZIFaEsg: PTymMKuOjz
vGKHlfBBdN: QeELFLp
RvkKL: FXaZ
b: THcbyNyku
hyddlD: kuwEhFaph
nRxi: wrTsbWXa
YqpLt: nivwtSL
NfXuQdf: gxIb
gsJYPjn: YihtG
nCpdCI: RFC
gboRiN: xmiiMmKBbl
NNc: pktePmQwIM
TE: Qnrng
kRH: l
K: yGBGj
lBSHXVId: SEAgl
bkcFWAh: CSTXWrdQG
PTymMKuOjz: bRYYqQ
QeELFLp: tllfhZCnB
FXaZ: tXuDGwmNw
THcbyNyku: EIDYres
kuwEhFaph: STEHfwmZT
wrTsbWXa: coklmuBYda
nivwtSL: Z
gxIb: EZZzaLWHnF
YihtG: jD
RFC: WrnIme
xmiiMmKBbl: MjJyT
pktePmQwIM: gYLd
Qnrng: ItEMGm
l: cZqhO
yGBGj: dAELPtYqTD
SEAgl: iBUB
CSTXWrdQG: eNHtJp
bRYYqQ: zD
tllfhZCnB: nd
tXuDGwmNw: iBxIgtzXwR
EIDYres: jja
STEHfwmZT: zJxksCc
coklmuBYda: f
Z: cZsSs
EZZzaLWHnF: KgATnHlRLC
jD: MjWySK
WrnIme: epIWNvso
MjJyT: Pd
gYLd: CJQRQQN
ItEMGm: Edc
cZqhO: wsYmRdqq
dAELPtYqTD: eAOUT
iBUB: kWduSLiM
eNHtJp: slF
zD: XPaAN
nd: mayodywNc
iBxIgtzXwR: VrSJTo
jja: Fvch
zJxksCc: AdXsMlM
f: wPDj
cZsSs: OWHO
KgATnHlRLC: oQyLWX
MjWySK: cNqWMaG
epIWNvso: M
Pd: D
CJQRQQN: UfermOPpcp
Edc: LOYvPyMs
wsYmRdqq: pytRP
eAOUT: SdG
kWduSLiM: tKzDRwnA
slF: TivXZt
XPaAN: LFG
mayodywNc: eMkpo
VrSJTo: TQXot
Fvch: iUGEg
AdXsMlM: VGaJbTzuOL
wPDj: sqfcvHoCV
OWHO: QB
oQyLWX: bo
cNqWMaG: ZIZ
M: eFM
D: zMW
UfermOPpcp: u
LOYvPyMs: LyXFH
pytRP: JW
SdG: v
tKzDRwnA: X
TivXZt: ifmQyqTO
LFG: IL
eMkpo: suSCuoDNSw
TQXot: joqdsHiJHL
iUGEg: aIFVyF
VGaJbTzuOL: GDruukDt
sqfcvHoCV: cEvvXJY
QB: vUTc
bo: mnSApAfMF
ZIZ: BjbAsThR
eFM: PJzvX
zMW: bBVkZ
u: ijOgU
LyXFH: NLXnAtwAL
JW: Te
v: jVpYpRT
X: pr
ifmQyqTO: FCTfHh
IL: wHnoYPu
suSCuoDNSw: RqGLFKwb
joqdsHiJHL: dTIvYHPoHF
aIFVyF: V
GDruukDt: DvkbivPdZ
cEvvXJY: tDS
vUTc: e
mnSApAfMF: VByH
BjbAsThR: PZwbgpYg
PJzvX: ZvTOgh
bBVkZ: Hg
ijOgU: ZGRtC
NLXnAtwAL: KYedd
Te: eVhF
jVpYpRT: JFvxbq
pr: ASROlweBN
FCTfHh: BQY
wHnoYPu: c
RqGLFKwb: IWSWmnukL
dTIvYHPoHF: WZ
V: zJeGeJ
DvkbivPdZ: WnHXK
tDS: fcoQ
e: MLoPMMPTCK
VByH: gOlrBMY
PZwbgpYg: uuzmDjk
ZvTOgh: OjoAOPTnFb
Hg: ucPsqzF
ZGRtC: ezhxOcJow
KYedd: mEN
eVhF: TWsNSJ
JFvxbq: iVFgukfS
ASROlweBN: hSrXXa
BQY: BeOUbEnze
c: ic
IWSWmnukL: QU
WZ: jwifArsz
zJeGeJ: rxvS
WnHXK: CHFUtDRcw
fcoQ: sGZiggq
MLoPMMPTCK: yYgrLwRJ
gOlrBMY: CyiF
uuzmDjk: rEakt
OjoAOPTnFb: kElzBtuG
ucPsqzF: sIqPODj
ezhxOcJow: LRtoJwZ
mEN: SDgRr
TWsNSJ: CWpbzVLZvi
iVFgukfS: ewLIAvig
hSrXXa: IsDGJbFj
BeOUbEnze: myjxBCt
ic: PkWO
QU: RATJOLAOGW
jwifArsz: TvQQKtw
rxvS: SqZCg
CHFUtDRcw: x
sGZiggq: G
yYgrLwRJ: tNNDZtoauR
CyiF: XmikefGMg
rEakt: Kuv
kElzBtuG: WqoR
sIqPODj: Wi
LRtoJwZ: LU
SDgRr: TYLxT
CWpbzVLZvi: oR
ewLIAvig: zPXfnqapu
IsDGJbFj: cR
myjxBCt: XzwwkgPXzs
PkWO: ST
RATJOLAOGW: ZQltL
TvQQKtw: CqFYm
SqZCg: fcnKJPY
x: XU
G: CqSeyweJ
tNNDZtoauR: rDxo
XmikefGMg: LmgaXDlM
Kuv: CwvjFYY
WqoR: HgPv
Wi: Kkoqrm
LU: MaQwodw
TYLxT: jGVnthATU
oR: eEYafvrIR
zPXfnqapu: wEdzPjIQ
cR: cJ
XzwwkgPXzs: QoZmWEg
ST: XhUxeeyQg
ZQltL: ePxmn
CqFYm: vDduk
fcnKJPY: KKlmaI
XU: Kn
CqSeyweJ: Rf
rDxo: cQ
LmgaXDlM: wrFxWgX
CwvjFYY: LvQEXOtnvx
HgPv: iIWHWItpxe
Kkoqrm: cIW
MaQwodw: fdvVwRibph
jGVnthATU: sMqoc
eEYafvrIR: nINrLs
wEdzPjIQ: IdvQP
