ENCODE
YlqVxgXzkW: LhzMYOIK cFe BoBe NkrnPJljV jWAACt DE JtsrJimkMr A vbJm KArfYjAnH YSb hrfUEbP ylxFiFvGSx W EIxMYWHqC lMBleO dDNTEbQ vsnADX VLwviSgWSz dk pmtKEFvj wNLoITMXM nEo lvPonWmJ oJ sDho AsGLitg bEckurKBW IfD uFfGrdGG BWIjJd VdFGgXT hurtrBUsi FNOFeTK KLEiwEN ClOtK uq UO KtoSGTv ZxzDeCjsd mpv ZbOJLEswy GyhMkqt mXGDEQ munyIHmNDm snRLwogUk cI SqI gnSCWDCsrd qiQP dQJafjJ pzTDxO iDyPBySvS pKoVydP vOIUpcfoEX GMTZbCVgBg SpHxJ s pdeuT lzT FHVAt E XXOwVKWZc QtDgCzkC kpEULSAkI AY HhQlknhQ hdgt uL pUafGas RVgIO bHNohLnoXb ROaF krFTJ zVPRnMuWbO TEDGhPgSxc zLGgrFMmF mUluB GWoABD hV WxppgypmuR Igcu ELvOTXJk OQ wOFjcjZJ NScKtZC VB RFJmIQPCaL AuZwYy y cuTAXmK aMojnzQu qq Rtlj vDsElQo NduLbDktQ qcsY rngUw MLWLl broQijWXrW
LhzMYOIK: EMMlGS
BoBe: jCr
cFe: GOBlo
NkrnPJljV: YEzK
jWAACt: SB
DE: cxKPKK
JtsrJimkMr: xBNxRMvRU
A: mAojsLLtvr
vbJm: KdGWgLpCEs
KArfYjAnH: lU
YSb: neLCquYR
hrfUEbP: OybAgwgv
ylxFiFvGSx: uX
W: ouEr
EIxMYWHqC: TPiaEDbZF
lMBleO: qrCeIhshjB
dDNTEbQ: ZlhHjZBNi
vsnADX: kxUm
VLwviSgWSz: wNdoLiLUEw
dk: jtNaxD
pmtKEFvj: flXBCYyx
wNLoITMXM: LgDFFxnK
nEo: FgUlcjhjCy
lvPonWmJ: YAdWSVsgm
oJ: LfAwBu
sDho: PoMQAGRZd
AsGLitg: jatXMuxnR
bEckurKBW: QGFuIEnKGI
IfD: jAQD
uFfGrdGG: yDXyMv
BWIjJd: BK
VdFGgXT: P
hurtrBUsi: QsqkhW
FNOFeTK: r
KLEiwEN: rrjlZangL
ClOtK: ckWo
uq: CVhS
UO: VzazcPQvkz
KtoSGTv: RY
ZxzDeCjsd: tHJgFu
mpv: mIGpJNFvy
ZbOJLEswy: jmzW
GyhMkqt: RQDcWj
mXGDEQ: DX
munyIHmNDm: gtnVjuWpBn
snRLwogUk: VvrTeQYVN
cI: ujYOQvskU
SqI: kdJS
gnSCWDCsrd: AzqaKqHGA
qiQP: hq
dQJafjJ: GQBBwTZgEg
pzTDxO: HWOi
iDyPBySvS: gQXSVf
pKoVydP: hlpefZi
vOIUpcfoEX: n
GMTZbCVgBg: pi
SpHxJ: QbbnSJjK
s: yZ
pdeuT: iiqA
lzT: tYiWavjH
FHVAt: WhiucAc
E: cOVTwsRR
XXOwVKWZc: UOyMAURUa
QtDgCzkC: qJilTIxkxS
kpEULSAkI: JyCMCXDP
AY: RapQc
HhQlknhQ: DGaIDRRGJ
hdgt: NetuRx
uL: UNyKiq
pUafGas: rAzTfMRcv
RVgIO: bZSej
bHNohLnoXb: wnVs
ROaF: KAjFz
krFTJ: uZ
zVPRnMuWbO: xXccyz
TEDGhPgSxc: hJc
zLGgrFMmF: HFGCUFr
mUluB: csYUQnWKoG
GWoABD: fkysibvSg
hV: DdqqpGqD
WxppgypmuR: SoAPNum
Igcu: QGtu
ELvOTXJk: YSzNoSpzmj
OQ: HBHOEYO
wOFjcjZJ: uouS
NScKtZC: ABql
VB: flnh
RFJmIQPCaL: hU
AuZwYy: aKkUqJCuE
y: Nm
cuTAXmK: KDVRHmxMS
aMojnzQu: N
qq: RpwHYQrR
Rtlj: yJPKKkipVE
vDsElQo: zsLb
NduLbDktQ: Uhg
qcsY: vVz
rngUw: nmNFWMr
MLWLl: T
broQijWXrW: IYti
EMMlGS: htvxtFiK
jCr: feyI
GOBlo: XJ
YEzK: HDoWVeHlK
SB: oOp
cxKPKK: ZigBha
xBNxRMvRU: mEXAnar
mAojsLLtvr: gXnJpkkxf
KdGWgLpCEs: SprRZ
lU: brATEyOy
neLCquYR: wXsg
OybAgwgv: bqMHPL
uX: gCwGNjGprL
ouEr: kttAXk
TPiaEDbZF: Gga
qrCeIhshjB: CGy
ZlhHjZBNi: IIDQKXrrs
kxUm: OIKlNV
wNdoLiLUEw: pYqAT
jtNaxD: a
flXBCYyx: XWWgA
LgDFFxnK: thgLDjI
FgUlcjhjCy: xdBM
YAdWSVsgm: NfXIjqCkHM
LfAwBu: fbshyGfOF
PoMQAGRZd: LjDtFRfIr
jatXMuxnR: hXbxh
QGFuIEnKGI: kyIXDj
jAQD: UzyXWbx
yDXyMv: BXyz
BK: YZFPBUJb
P: FQJLQvprS
QsqkhW: nENFZfybzf
r: IZNsgt
rrjlZangL: S
ckWo: KJQWvf
CVhS: FUOGkOsy
VzazcPQvkz: WWEmgLK
RY: rDFzaJY
tHJgFu: PCzOiMjI
mIGpJNFvy: IhchqyVom
jmzW: rIR
RQDcWj: H
DX: UTWkw
gtnVjuWpBn: LAHeINUf
VvrTeQYVN: oMejZ
ujYOQvskU: sW
kdJS: lFWZj
AzqaKqHGA: faW
hq: IeOEzK
GQBBwTZgEg: wPC
HWOi: ePgRsneyy
gQXSVf: MLGPZOaV
hlpefZi: rIoESTAhau
n: HYPth
pi: UOhFKtKfPm
QbbnSJjK: km
yZ: eOtctxEXX
iiqA: PmvP
tYiWavjH: KFEMSETDEq
WhiucAc: jjM
cOVTwsRR: czXBeMWNK
UOyMAURUa: FNA
qJilTIxkxS: SL
JyCMCXDP: ybIjg
RapQc: BTS
DGaIDRRGJ: JGJUR
NetuRx: Rz
UNyKiq: jBhd
rAzTfMRcv: kUKX
bZSej: wGqwcif
wnVs: fLbzFCSlVx
KAjFz: dQmsaoe
uZ: joOhS
xXccyz: La
hJc: kGmULmGx
HFGCUFr: dvtfNHomc
csYUQnWKoG: HpgK
fkysibvSg: GRAXurKFVd
DdqqpGqD: DgXgrZ
SoAPNum: tqtnr
QGtu: vBzp
YSzNoSpzmj: p
HBHOEYO: GzBS
uouS: uc
ABql: VlL
flnh: ezhXeu
hU: gl
aKkUqJCuE: lZgAExw
Nm: QccnShV
KDVRHmxMS: pEn
N: QfjgGfaVg
RpwHYQrR: FxxiksIcOB
yJPKKkipVE: LsJsGum
zsLb: Q
Uhg: z
vVz: ug
nmNFWMr: Ipklv
T: J
IYti: exdqR
htvxtFiK: Qn
feyI: qWNoPD
XJ: yR
HDoWVeHlK: sJYAP
oOp: zK
ZigBha: rtDEmn
mEXAnar: vphPxgvxRs
gXnJpkkxf: UiPU
SprRZ: WfDTaAMyZY
brATEyOy: BYpBoptWie
wXsg: qPt
bqMHPL: qPNpUj
gCwGNjGprL: kmW
kttAXk: YF
Gga: FwTDrdR
CGy: ZPLzZP
IIDQKXrrs: MDjNgLNrI
OIKlNV: VFpMc
pYqAT: Ybv
a: GCWAuNGcIu
XWWgA: oAgXRZu
thgLDjI: gocfvQ
xdBM: vF
NfXIjqCkHM: RrDTWOWU
fbshyGfOF: w
LjDtFRfIr: Y
hXbxh: tSEio
kyIXDj: UQ
UzyXWbx: JbEBVaHeaP
BXyz: brZpxfZMr
YZFPBUJb: ExkyYkGPjc
FQJLQvprS: xvKIxtwjN
nENFZfybzf: teWqnVBWH
IZNsgt: Sc
S: Et
KJQWvf: KSH
FUOGkOsy: hduU
WWEmgLK: Stn
rDFzaJY: ppGrNqiVxR
PCzOiMjI: hZfGwWiJg
IhchqyVom: AnOTjB
rIR: lqOYuEp
H: gjeFeJa
UTWkw: Au
LAHeINUf: KyZK
oMejZ: F
sW: vAi
lFWZj: ykjiWbJ
faW: KvnPzQjAPy
IeOEzK: HZBDXN
wPC: mWTSnAUa
ePgRsneyy: hbWWdBT
MLGPZOaV: IMezLWtkj
rIoESTAhau: pk
HYPth: FguLHpjl
UOhFKtKfPm: CVRl
km: HYikZDIZD
eOtctxEXX: nnNFCzF
PmvP: lDbjqqCSF
KFEMSETDEq: KnJmeCTyEn
jjM: xwOQlGZ
czXBeMWNK: naZNmdGOb
FNA: WVTxzvWd
SL: Giz
ybIjg: oXg
BTS: EwkVA
JGJUR: izbzfz
Rz: m
jBhd: iW
kUKX: iB
wGqwcif: pKbu
fLbzFCSlVx: zCXzPYqT
dQmsaoe: xFyrZww
joOhS: eAHupfPqI
La: OZMmGJ
kGmULmGx: WFhTlwJlnd
dvtfNHomc: BUF
HpgK: b
GRAXurKFVd: Ld
DgXgrZ: ynNl
tqtnr: fjesy
vBzp: VbzJbvYP
p: FaLx
GzBS: xBtU
uc: KS
VlL: oNPItGwbLD
ezhXeu: MGgguAIgz
gl: OCp
lZgAExw: WSZBOemyuK
QccnShV: K
pEn: Fwrku
QfjgGfaVg: XxBKRngPr
FxxiksIcOB: lmsO
LsJsGum: berGXfI
Q: lGJRsNZyrS
z: weebJjlnTL
ug: xWEIPf
Ipklv: qnXjdJPFB
J: oMI
exdqR: OiJgkYBTC
Qn: qDBY
qWNoPD: VXunH
yR: tPstqP
sJYAP: fMl
zK: CoJjSt
rtDEmn: lcwLqeTM
vphPxgvxRs: l
UiPU: It
WfDTaAMyZY: xbagVtqTs
BYpBoptWie: byv
qPt: md
qPNpUj: dbtiYYD
kmW: xHyedgj
YF: ConoWyj
FwTDrdR: sT
ZPLzZP: TGbCUJzD
MDjNgLNrI: Z
VFpMc: hpvYn
Ybv: whrhTY
GCWAuNGcIu: Zcc
oAgXRZu: aeYSisdZ
gocfvQ: acqoh
vF: EP
RrDTWOWU: vVTGsQg
w: YiQP
Y: XRYYei
tSEio: LoKAdkBK
UQ: f
JbEBVaHeaP: WqX
brZpxfZMr: yxawARGBSo
ExkyYkGPjc: AZcMNwN
xvKIxtwjN: DDYug
teWqnVBWH: OrbQGNCqtq
Sc: SMJKUHdlMX
Et: mBSYx
KSH: OXuuoT
hduU: APQlqMeN
Stn: rM
ppGrNqiVxR: Hs
hZfGwWiJg: Ip
AnOTjB: HcpWasTKeX
lqOYuEp: PlYi
gjeFeJa: DIZqH
Au: kx
KyZK: kDeT
F: qB
vAi: mSKDnRY
ykjiWbJ: isiE
KvnPzQjAPy: OJPwhMwawn
HZBDXN: AEmxjv
mWTSnAUa: CpOBQiha
hbWWdBT: g
IMezLWtkj: eDcPp
pk: M
FguLHpjl: PLylmAMO
CVRl: UVyT
HYikZDIZD: ZUfCJu
nnNFCzF: IRwsLuIw
lDbjqqCSF: tTMhJjItod
KnJmeCTyEn: OPTPe
xwOQlGZ: ZswOplCglX
naZNmdGOb: jJjsLdito
WVTxzvWd: QOor
Giz: ADozqux
oXg: QRrkv
EwkVA: eG
izbzfz: alcv
m: bHWjmix
iW: qluMERCg
iB: gHwlhRSf
pKbu: u
zCXzPYqT: v
xFyrZww: wdfH
eAHupfPqI: aCotAlHg
OZMmGJ: fWkCKPNtgI
WFhTlwJlnd: X
BUF: NQVKTg
b: QJVwIE
Ld: fFwkvqeg
ynNl: ywpkDT
fjesy: qoQGa
VbzJbvYP: BjxgG
FaLx: kbyUd
xBtU: lnQKzGX
KS: EMeodKj
oNPItGwbLD: oaNBbg
MGgguAIgz: hDyt
OCp: ZZ
WSZBOemyuK: IRPlRTtZFo
K: XDlZkQ
Fwrku: UBix
XxBKRngPr: YxmK
lmsO: YaZCarQj
berGXfI: HVs
lGJRsNZyrS: WYb
weebJjlnTL: NYIMX
xWEIPf: d
qnXjdJPFB: lAfKJJF
oMI: NJtwzfYQGh
OiJgkYBTC: Rrwvqpzn
qDBY: AHGkJoAbbE
VXunH: V
tPstqP: IjTdDrnt
fMl: e
CoJjSt: ASMli
lcwLqeTM: JG
l: sjLiRCvj
It: oVy
xbagVtqTs: kCMHRf
byv: JKQ
md: noDHa
dbtiYYD: bMd
xHyedgj: WaCBxKfY
ConoWyj: aXhIouz
sT: mXE
TGbCUJzD: c
Z: db
hpvYn: jotfaCkBOZ
whrhTY: XdiV
Zcc: gMopq
aeYSisdZ: GLJhpYJ
acqoh: dTqoHC
EP: IBvdr
vVTGsQg: daLAJjT
YiQP: xPms
XRYYei: wt
LoKAdkBK: UobgVNFf
f: Uynf
WqX: rNfous
yxawARGBSo: AowSeK
AZcMNwN: qFONzktVS
DDYug: VrJrmlCT
OrbQGNCqtq: sb
SMJKUHdlMX: I
mBSYx: JX
OXuuoT: JCVKrNaSZb
APQlqMeN: BozkJRTU
rM: sXJfgWw
Hs: yotOCT
Ip: xyc
HcpWasTKeX: ISIZt
PlYi: AEbJN
DIZqH: wMVn
kx: ad
kDeT: pSgDgSAY
qB: BwjgoU
mSKDnRY: NaVerUm
isiE: rxyxSEEf
OJPwhMwawn: RbAFDn
AEmxjv: mI
CpOBQiha: YbuoNFzer
g: x
eDcPp: ehfKXTtDj
M: WaCmr
PLylmAMO: Pds
UVyT: IGN
ZUfCJu: fR
IRwsLuIw: sHcJbNzN
tTMhJjItod: zjpgSNSlJx
OPTPe: rCg
ZswOplCglX: awBCcOhnqi
jJjsLdito: Hmdc
QOor: dWBAJigyUf
ADozqux: VcvoelYU
QRrkv: tH
eG: ZUPydfOoW
alcv: mhES
bHWjmix: GRPoVtcnSR
qluMERCg: LmRDVzFxQj
gHwlhRSf: hwEDcvlc
u: daGJZKE
v: LjlobTb
wdfH: CQkf
aCotAlHg: LNFVsOn
fWkCKPNtgI: Bxfftezu
X: ODdgBPnvZG
NQVKTg: sXJntUb
QJVwIE: ipl
fFwkvqeg: ZY
ywpkDT: TGPGO
qoQGa: SIGHg
BjxgG: cOJvZBjI
kbyUd: AdOjtTqPK
lnQKzGX: yUABLaHtM
EMeodKj: wVmvmLDpFu
oaNBbg: eCYgep
hDyt: OxakSz
ZZ: hynRCOhu
IRPlRTtZFo: yCcgpak
XDlZkQ: cQ
UBix: hjr
YxmK: oyfomxVd
YaZCarQj: DeSGonaQp
HVs: VxSxZuVTy
WYb: Jn
NYIMX: wso
d: IllpUfaTB
lAfKJJF: fgG
NJtwzfYQGh: OtCBDe
