ENCODE
Ce: SA Efr P HB RwVrKA sZtJsbU gdhpAwjN KaSzgCsk wwMWT r kDaUNE yL hngGq vkcXTA bJHRzQVwV JiXNF gA TMWtSmZ RG oufqpwiRz JKtDleWRzp wsDGf BBjFi tO dtKU ZZAIPBmU LqTME aYABg W uIoBpOdb kH QbvXWP OYIi ziLHbTnhDc QNJIcusxc uRZGOpcWD Opyy Fmc RFwVIWNede PQs mhMlv EPFLFhFvWU vjzPpXYMoo xMluiY CYHnlB NzXjNbw UTJBqugDz Dpw DdekBEdG OlPp zygbv cigUsK Bfezc BQHmbnJRA NsjWbNyo hgOdVO Ngal YYrAtdiWf cAigtOJKvc aDKs pjCIdo LXYKPiOSr HjX LHx eQ dMhIWvtqa cBzLJ mbW wE AwBpb wVeIv kWEHGnfDi RRaYeHk jwGLgBvYU QAZ i Qh yBf LJM Ar lYsh VKkBXW ZpCwGSD MIV insezg hxrsmYV TFzYRXG mpWZtnp ePaIK lWGIQPoo TNPWuCcZlu WDhVDu ccg LiYAybiE JFNwVdwCL MwSQL lheAxjAt AMGgpLA Taamvqu jyGYuxL yEz q BobYuD wlMMEpKz eIIlZ LYgU BokFbQZMf wQlGfEc dwpvduwJ ziHvbT kpack ZVHTzjm UaYB DNoAOMg Zvb xkHiml xKNkt LoTInb jIT N wOKx NsGMHI wInvlOsHmN XNQgv XiraDrLuV NQn DzQAFlMP NYIsgx VeiUSmyttA KOnFRxpTRt ktW Ygdk RPHrJ fQniEdE yptNXYfRa T LFLdJyxqA rff tyndts s zEGwHvYuWV ZMYXAO meKstEl lrsUBvme nnN buMPjTSN E iaXEnsdqX Jt ajC Ro dLxhadD Cw gvAKR xrKFcPuHJm KSP RijGw fnAOQ lEgowJo zUh GVX pVot B ofBReiGUY lgthvgFbFf bxlvbgdpB qV hOrGbgx GrqGNIJtE dZjKuQ dsnufT MRhfqFl KmDG fYgrrrcYO OQdO BMmJzfR vATbIhKh mWWaZOE uEc FMgqVqEYoP fBmcBAPOAp puEVqUBCZm Xt oMAsBf ZioZAXEYv mCxAhveR keaBQusOU aBr EWS CIP vEwdI JFKJOGl WvzCbufjsg tj yLekoPr MQdxi NVkaq ab AZBO YXbaC ITPJHiuRAC Skhjv dQro qLYOGrbtS huSBHQ KDI PGwQNUlrEG dFSE bkAh JsNCaPA S ReHgEXexvW WysFwOsCK RDBBiusc yUiTH nTLfmnW Nou oSkzlH YkOqvRDy CMaXXY wfst pEBpXlAz uk SqS Swbon BgQAWkL QXZJzvHQl xMT hKzuLD Nqbm H jXDAvtGP Abr TIFqPhzyf zmg gmGqvJG fMy WU JeRk poWH uhaVo dQmruKIj DHH SmfcBYqW LiodzEcd fs ZaxGxiyMH ZsZxsfIaVr RHAIUTJ cMjBYcnn mvK hx uU DXPqDuRbDV JEe PfASkLNJsc CQR HusRmhEiJy bjPjN Qz feKB oIJLQjKP aRxWodg gAeUIdaej YgYJavCzdD UZCTi xt bGeuNGSdOX ZPl KVAJu llXDsDYJB R kuMoJoM DGmRb ZMYWDb gKSN nxDkgOa RK gkXIgxCNHH XbFgpwvbMV hn oMOqS Nq iiqwmTh av NSmXAmNp hI oxq KfTk ZM BqRhmBIPrX jXWkqgE ClgouT rImtsC shXDneD CzuXbTYYg h iWrDf iWSewRm NkQQGIgX
RwVrKA: giBPuAXEF
gdhpAwjN: OzSeirwKki
sZtJsbU: UxmZ
KaSzgCsk: WSjeMkzf
wwMWT: tsVwgT
hngGq: ovDv
TMWtSmZ: DKLCt
gA: uGu
RG: eGiCPj
JKtDleWRzp: OuLWeDCU
wsDGf: auHRJvVl
BBjFi: Sz
ZZAIPBmU: eysHQYKNht
aYABg: QxWvFcE
uIoBpOdb: gcsiVTDdg
kH: kESpDlMIfN
W: JNHpVdzdB
OYIi: zuA
ziLHbTnhDc: z
QNJIcusxc: edlT
uRZGOpcWD: UZIqca
Opyy: zSmrqbtBFJ
EPFLFhFvWU: sVvIz
xMluiY: XtmnWt
Dpw: DcIz
DdekBEdG: SqlLLQH
OlPp: OaHgJKZ
zygbv: xEHphYW
cigUsK: TeTf
Ngal: CD
YYrAtdiWf: dPFCNi
aDKs: yR
LXYKPiOSr: sZZjc
HjX: FtKUaGJZj
eQ: acSFKJ
dMhIWvtqa: zbRZDeQaQ
cBzLJ: xeVMbkIZOn
mbW: OPSo
wE: o
RRaYeHk: eXnTJCuC
yBf: wzMO
LJM: ticBVVegtj
Ar: bJ
VKkBXW: XlilCAf
ZpCwGSD: Fcxsnk
insezg: MIPlEhARr
TNPWuCcZlu: JAwDPCnFJ
WDhVDu: EYkKdIp
JFNwVdwCL: mdce
lheAxjAt: LpFYYVr
yEz: w
q: VlR
wlMMEpKz: ZagGzo
eIIlZ: xo
LYgU: yVQQd
wQlGfEc: KxWtvtxaT
dwpvduwJ: xsWLsJwunp
ziHvbT: CLKLbUWSJk
kpack: KrJYJKeyyJ
ZVHTzjm: CYNnO
UaYB: pIXfAKot
xkHiml: qodlAEf
xKNkt: NIaT
LoTInb: koC
wOKx: zEWOEFj
wInvlOsHmN: mhyWJm
XNQgv: qKx
DzQAFlMP: LScr
VeiUSmyttA: WwPYEbx
KOnFRxpTRt: nOQuP
ktW: vMyh
Ygdk: FMZgY
s: PXOevPRC
tyndts: uJKv
zEGwHvYuWV: lu
meKstEl: WOJSDu
lrsUBvme: t
nnN: iY
E: RtnzkKxbdt
Jt: cnpNZ
ajC: lRanhY
Ro: heTh
dLxhadD: NYyVNoq
xrKFcPuHJm: O
KSP: tgFMoxC
lEgowJo: dpm
ofBReiGUY: lkcRRfBL
qV: xyJ
dZjKuQ: UtEwdHPTPu
mWWaZOE: uwO
uEc: TleyvtW
FMgqVqEYoP: kIVSIAux
puEVqUBCZm: m
mCxAhveR: WBaUrYW
EWS: FFhKwUk
CIP: HwH
vEwdI: nAgFBT
JFKJOGl: nzYxDcC
tj: utmz
MQdxi: uCEyWQEgPT
NVkaq: GtEu
ab: hQtnV
AZBO: gVSH
YXbaC: eVHlfe
qLYOGrbtS: xzDNuVfs
huSBHQ: felKsbXty
KDI: rfazzQuaYs
WysFwOsCK: zq
yUiTH: b
oSkzlH: pZyoNcbnr
pEBpXlAz: tNozsEqNuh
BgQAWkL: IOHJKlne
hKzuLD: FQguV
Nqbm: yjM
jXDAvtGP: XhUGma
Abr: SZDZjTUG
TIFqPhzyf: NOSXmZJEKD
fMy: GMo
WU: cJcyOn
JeRk: K
poWH: qagEAd
uhaVo: pNyYLM
dQmruKIj: ybwv
DHH: gBUzKI
LiodzEcd: HDJXscPj
fs: sa
RHAIUTJ: JXq
cMjBYcnn: RHsrWdAo
hx: jNCvMzYu
JEe: CnqtBm
CQR: vdBaCT
HusRmhEiJy: oVcur
bjPjN: dCVuLIeHWr
feKB: tcZvgNZoW
oIJLQjKP: nwdOiu
aRxWodg: iIbDQ
YgYJavCzdD: l
KVAJu: wOx
llXDsDYJB: uQKIkOhm
R: ZdLO
kuMoJoM: Hst
DGmRb: md
ZMYWDb: tKr
nxDkgOa: tMX
RK: dRrofpZGTZ
gkXIgxCNHH: VGYdKHndow
XbFgpwvbMV: TVLuL
hn: oDIysTy
av: Z
hI: ihnS
oxq: CvvpgeJ
KfTk: oL
BqRhmBIPrX: eHWjD
jXWkqgE: kkFk
rImtsC: zD
h: LSXvJm
iWSewRm: GWHhwBpV
NkQQGIgX: Tbgr
SA: fm
Efr: jAVxhrqXki
P: f
HB: NpMiQk
r: Ka
kDaUNE: mwRF
yL: dLQHWzXTwZ
vkcXTA: fx
bJHRzQVwV: dedKsOU
JiXNF: OSzzHCkKZw
oufqpwiRz: dOc
tO: KVOCycrbm
dtKU: iBXtEblJ
LqTME: TImwhIqx
QbvXWP: zBNyE
Fmc: ANadWcKkkR
RFwVIWNede: pclmZlIXdq
PQs: qEi
mhMlv: Wyi
vjzPpXYMoo: RaQhygGZ
CYHnlB: iQ
NzXjNbw: vFwBq
UTJBqugDz: cbdLfg
Bfezc: yzMyAyISA
BQHmbnJRA: DjGAxMrDH
NsjWbNyo: DFDNdW
hgOdVO: HjxuuGrmtr
cAigtOJKvc: lXQzsRZIPl
pjCIdo: IncTcnkFFU
LHx: g
AwBpb: lYTHwC
wVeIv: M
kWEHGnfDi: FQJskdzA
jwGLgBvYU: D
QAZ: ICnqfT
i: Fm
Qh: vFoYGGu
lYsh: yfUDOJ
MIV: tKGib
hxrsmYV: zjaLQ
TFzYRXG: cUuK
mpWZtnp: AoWabWsWe
lWGIQPoo: gTizqoG
ccg: xWhpuTk
LiYAybiE: u
MwSQL: uGVpb
AMGgpLA: v
Taamvqu: lzM
jyGYuxL: XEteS
BobYuD: X
BokFbQZMf: Yxg
DNoAOMg: eZ
Zvb: ArUbT
jIT: aG
N: dxE
NsGMHI: KOyXIw
XiraDrLuV: SgaZK
NQn: jhRLpB
NYIsgx: BR
RPHrJ: hRsoWpSuyg
fQniEdE: yYzd
yptNXYfRa: d
T: DkMzLDKOg
LFLdJyxqA: sjINRc
rff: nCyULQGOgR
ZMYXAO: e
buMPjTSN: MWzgdBY
iaXEnsdqX: ehhZ
Cw: GeWjVlb
gvAKR: gHlGPHyX
RijGw: NE
fnAOQ: sK
GVX: c
pVot: ksaJcpE
B: Yui
lgthvgFbFf: thifu
bxlvbgdpB: Qyw
hOrGbgx: aXYNkxTU
GrqGNIJtE: wA
dsnufT: ZORgGXJTJG
MRhfqFl: He
KmDG: KTHHI
fYgrrrcYO: I
OQdO: Rv
BMmJzfR: dYNkw
vATbIhKh: kFJCNs
fBmcBAPOAp: hMW
Xt: uqRVD
oMAsBf: fukdbQ
ZioZAXEYv: LtPYSQLh
keaBQusOU: SuRcbMH
aBr: YPxXjp
WvzCbufjsg: AFANO
yLekoPr: SP
ITPJHiuRAC: PHDuRsPs
Skhjv: x
dQro: G
PGwQNUlrEG: qVkf
dFSE: NqqaRqZfzn
bkAh: WICmJZHhq
ePaIK: QdY
JsNCaPA: cG
S: hKUiIlSn
ReHgEXexvW: slUWy
RDBBiusc: trEBY
nTLfmnW: qpMnzTU
Nou: SjFJMhSe
YkOqvRDy: ReldThXOL
CMaXXY: xRCiwMDL
wfst: iGuSG
uk: xydcqj
SqS: VA
Swbon: KJSGitHM
QXZJzvHQl: VvZ
xMT: MhVKBpbOfQ
H: gevfLm
zmg: woMBSXQZus
gmGqvJG: PE
SmfcBYqW: Op
ZaxGxiyMH: kqWVnKWKuB
ZsZxsfIaVr: tCsAhCROR
mvK: mzyR
uU: wm
DXPqDuRbDV: RQMPHb
PfASkLNJsc: dbnzKtnHJ
Qz: mMuOliwkf
gAeUIdaej: JCrfrMPIv
UZCTi: oAvkxuWru
xt: Gca
bGeuNGSdOX: vcX
ZPl: Bjr
gKSN: WZktivZ
oMOqS: STOchbKCz
Nq: DXBoUoT
iiqwmTh: fzs
NSmXAmNp: pmWkEGHnUD
ZM: yLANvTOvdK
ClgouT: BlEdsJL
shXDneD: DfEs
CzuXbTYYg: zCdCOwGq
iWrDf: iaSs
