ENCODE
SKSF: DUvKa pktZM QfDiKFpkc Txy lvmNYYZI WKDLiqf
QfDiKFpkc: W
Txy: uG
lvmNYYZI: VJfZOi
WKDLiqf: cjZqiQ
DUvKa: qon
pktZM: Nvjyd
W: ZJcpO
uG: dEb
VJfZOi: QIYY
cjZqiQ: dTPdGfh
qon: TYa
Nvjyd: ADAqibGwN
ZJcpO: eEqhPqLKc
dEb: MREXGIR
QIYY: jzRxm
dTPdGfh: kMqLGV
TYa: UsdVQqNn
ADAqibGwN: nG
eEqhPqLKc: StUv
MREXGIR: jOlooeVuc
jzRxm: TkIdKpr
kMqLGV: ttHspg
UsdVQqNn: EgEUtfdmED
nG: caLUEkPXDx
StUv: RUS
jOlooeVuc: j
TkIdKpr: LnmLAoP
ttHspg: QCRFQopdDT
EgEUtfdmED: eoZCOQBH
caLUEkPXDx: xEZzSX
RUS: ObqV
j: gKDZtAZR
LnmLAoP: Ir
QCRFQopdDT: KY
eoZCOQBH: DUNAcjryaF
xEZzSX: uxgcj
ObqV: q
gKDZtAZR: zfjBAxCLs
Ir: obVDJZvdr
KY: ZfOaL
DUNAcjryaF: AyGdFI
uxgcj: nCnERITaPh
q: uhHE
zfjBAxCLs: oPeKfWuq
obVDJZvdr: Ab
ZfOaL: hWnc
AyGdFI: lOVmKQHQQ
nCnERITaPh: NFQYSpXDeM
uhHE: fJV
oPeKfWuq: fjqp
Ab: MbITTBtZ
hWnc: rAIZ
lOVmKQHQQ: ORWIC
NFQYSpXDeM: s
fJV: JRwa
fjqp: PdSVXAd
MbITTBtZ: XcAWNKGML
rAIZ: hMkYyDOWcp
ORWIC: zskYnYCrqZ
s: E
JRwa: eRVyKhDQVV
PdSVXAd: rxRb
XcAWNKGML: SbsWQIPsGw
hMkYyDOWcp: aDd
zskYnYCrqZ: ABBxNb
E: boo
eRVyKhDQVV: Tm
rxRb: aHBmWv
SbsWQIPsGw: vsXWGha
aDd: slgx
ABBxNb: TzEFSnOUM
boo: BCWlgqKQw
Tm: UCG
aHBmWv: BRG
vsXWGha: OtBjxbx
slgx: pS
TzEFSnOUM: wyAl
BCWlgqKQw: DaJTDs
UCG: iIc
BRG: BwEQ
OtBjxbx: wGm
pS: hgBslkZYT
wyAl: swbUA
DaJTDs: FrtruHR
iIc: XVty
BwEQ: usKIwc
wGm: FnwXC
hgBslkZYT: oxlmd
swbUA: ShIGm
FrtruHR: ijIndL
XVty: hspcQrQMT
usKIwc: y
FnwXC: XkcaUpBJlS
oxlmd: IS
ShIGm: CvOaqQlpPq
ijIndL: kczDY
hspcQrQMT: URgMaY
y: bCnF
XkcaUpBJlS: ETcVoVSjKm
IS: MyMDnUdzj
CvOaqQlpPq: InwiISq
kczDY: ufTdbAi
URgMaY: Jl
bCnF: xIzoLOYCj
ETcVoVSjKm: zkJ
MyMDnUdzj: MH
InwiISq: PzRN
ufTdbAi: Bvfx
Jl: MhmBe
xIzoLOYCj: Ov
zkJ: aPgVNLWBrt
MH: ZNS
PzRN: hQoK
Bvfx: NyuVduPpBe
MhmBe: KSzjssw
Ov: BKzcvHdjl
aPgVNLWBrt: Lz
ZNS: hWT
hQoK: UMmDVb
NyuVduPpBe: fDGDESjO
KSzjssw: VbcfikvR
BKzcvHdjl: uVRYMprRA
Lz: PrvJEnh
hWT: uV
UMmDVb: ojnM
fDGDESjO: tHcXbHxvL
VbcfikvR: oOJKfyqzZ
uVRYMprRA: BizDF
PrvJEnh: sVchte
uV: NRNuj
ojnM: LxyQAuN
tHcXbHxvL: h
oOJKfyqzZ: RjjHEVy
BizDF: IY
sVchte: mxSC
NRNuj: P
LxyQAuN: iOe
h: YRl
RjjHEVy: JUiNTBqug
IY: r
mxSC: gwWLKwFt
P: QtkClK
iOe: yL
YRl: ULGlJGC
JUiNTBqug: FaRgqz
r: VPfCaAfC
gwWLKwFt: CLyzcI
QtkClK: YvQvghbooF
yL: SlEjp
ULGlJGC: ZmsSrwnDHq
FaRgqz: ENC
VPfCaAfC: AjrhD
CLyzcI: mNKrCkj
YvQvghbooF: FJcdi
SlEjp: dwJhMqo
ZmsSrwnDHq: Uyhm
ENC: iNKNfuxD
AjrhD: wiyTZHo
mNKrCkj: n
FJcdi: StcrVR
dwJhMqo: Yf
Uyhm: kLbilzjP
iNKNfuxD: tiWirFsalo
wiyTZHo: rMXacF
n: cebCaaTbHG
StcrVR: txo
Yf: yTQwPlq
kLbilzjP: oRSLqdrb
tiWirFsalo: SMIJKwFi
rMXacF: i
cebCaaTbHG: liUvhReVBJ
txo: NriN
yTQwPlq: IfCJrzeH
oRSLqdrb: KYxFtvfUkI
SMIJKwFi: gWOa
i: WXV
liUvhReVBJ: mp
NriN: ZasyrH
IfCJrzeH: U
KYxFtvfUkI: geeyphpgTg
gWOa: UyMZ
WXV: FzCwmyF
mp: UdXtNRhm
ZasyrH: ukxqQDz
U: Hn
geeyphpgTg: lXhdFJih
UyMZ: kchAcnXHYT
FzCwmyF: iLsNjdJts
UdXtNRhm: VpcoH
ukxqQDz: ZNNZvFSEa
Hn: TUs
lXhdFJih: UAbgSkonw
kchAcnXHYT: xZKJwTz
iLsNjdJts: yppl
VpcoH: kJVJcA
ZNNZvFSEa: VsMnTomc
TUs: QBmn
UAbgSkonw: Ert
xZKJwTz: QziOMzjEiC
yppl: OO
kJVJcA: jnbt
VsMnTomc: eFJYHqdj
QBmn: fjZUU
Ert: Vfqz
QziOMzjEiC: XMHMvG
OO: IWTriMJDK
jnbt: UPEWiuUdjh
eFJYHqdj: GlKavukFh
fjZUU: xmcrUXnY
Vfqz: aPvN
XMHMvG: gcXZWBAzX
IWTriMJDK: Kam
UPEWiuUdjh: cak
GlKavukFh: CuL
xmcrUXnY: xQxXwTJVM
aPvN: aJod
gcXZWBAzX: kfGAx
Kam: JizjsUGT
cak: nsR
CuL: TSuwUjJs
xQxXwTJVM: NiFvLj
aJod: GxPJzqsO
kfGAx: wKIdj
JizjsUGT: JkqkwhRjz
nsR: qdAOSfmWd
TSuwUjJs: eCh
NiFvLj: B
GxPJzqsO: yYIxIrPA
wKIdj: YEKi
JkqkwhRjz: IUN
qdAOSfmWd: SPvao
eCh: dGb
B: Za
yYIxIrPA: ZIWvAwy
YEKi: ztg
IUN: dWGqRmXj
SPvao: CA
dGb: zF
Za: hPKE
ZIWvAwy: VgtpEbruA
ztg: cmbrgNG
dWGqRmXj: VFark
CA: inSoUF
zF: pzSf
hPKE: AMaeuvZRFz
VgtpEbruA: UEuxC
cmbrgNG: rnwR
VFark: tBLuXb
inSoUF: vFLyV
pzSf: VsJHnSkLL
AMaeuvZRFz: vTWK
UEuxC: rSBigKag
rnwR: H
tBLuXb: VkHzZKgCv
vFLyV: nZrp
VsJHnSkLL: Hu
vTWK: SxCboOhHp
rSBigKag: WBF
H: tTIQWeQCdN
VkHzZKgCv: rOonO
nZrp: mTuAGfDE
Hu: KNGX
SxCboOhHp: Nr
WBF: bapQaSsh
tTIQWeQCdN: vi
rOonO: LCXUwj
mTuAGfDE: bPbSJHiyv
KNGX: NwbaU
Nr: kIdsYzw
bapQaSsh: zJlG
vi: RmhqXClIUe
LCXUwj: pjcNZI
bPbSJHiyv: Mq
NwbaU: jWO
kIdsYzw: mqUU
zJlG: gBeLKJO
RmhqXClIUe: lOwcHp
pjcNZI: HJ
Mq: HFTy
jWO: biO
mqUU: gbRBi
gBeLKJO: lvfbnI
lOwcHp: Nq
HJ: dMbFATkk
HFTy: jO
biO: Vj
gbRBi: aHMiRhN
lvfbnI: cuIgWqzgsV
Nq: cOcurR
dMbFATkk: jATBCAPln
jO: ritovuzxkh
Vj: onwZsUt
aHMiRhN: tTkChYEsD
cuIgWqzgsV: Bmk
cOcurR: p
jATBCAPln: WyEDwXTUIb
ritovuzxkh: gTM
onwZsUt: vfkytD
tTkChYEsD: NjTRdh
Bmk: aVhgtSv
p: UMpcWz
WyEDwXTUIb: vudUDQfGRC
gTM: LOAd
vfkytD: Xgyf
NjTRdh: xmrMPp
aVhgtSv: VNxKQX
UMpcWz: EN
vudUDQfGRC: pmLHqIo
LOAd: ZEncIqicyJ
Xgyf: z
xmrMPp: IMArpkk
VNxKQX: Lp
EN: J
pmLHqIo: UDq
ZEncIqicyJ: APRKHNRIWT
z: Jb
IMArpkk: jPQMVGQTG
Lp: hai
J: yAHORy
UDq: zm
APRKHNRIWT: qTBvCetseM
Jb: nTDvyJUa
jPQMVGQTG: VQ
hai: bjKot
yAHORy: TWhJ
zm: pvQpMjGM
qTBvCetseM: rbshIgYSe
nTDvyJUa: vdAfGfd
VQ: LxFiGdYr
bjKot: HWqJatpqf
TWhJ: AbHMC
pvQpMjGM: zdVr
rbshIgYSe: bIqH
vdAfGfd: zTVntIhr
LxFiGdYr: xjHogyLvk
HWqJatpqf: dwfYfOQZ
AbHMC: jaXKPX
zdVr: jK
bIqH: KT
zTVntIhr: ebPhv
xjHogyLvk: lTOb
dwfYfOQZ: vRKpCDiD
jaXKPX: w
jK: Y
KT: xBq
ebPhv: jxDLquppMc
lTOb: mGg
vRKpCDiD: qbyfnew
w: LcB
Y: xSCPRyuEM
xBq: zo
jxDLquppMc: qasG
mGg: F
qbyfnew: PFcRRwKjp
LcB: pExT
xSCPRyuEM: NmSdjwDy
zo: hOMsyCpe
qasG: gFc
F: zCkbTFFpA
PFcRRwKjp: TwRUorO
pExT: oNNnpuwgag
NmSdjwDy: t
hOMsyCpe: xBZ
gFc: MF
zCkbTFFpA: ULoYnQy
TwRUorO: O
oNNnpuwgag: jX
t: SEi
xBZ: qJMhfnSN
MF: nGvNEyHJC
ULoYnQy: QbXOxpq
O: nhENlg
jX: XUggu
SEi: LcNYwZYUg
qJMhfnSN: wsLyUe
nGvNEyHJC: ie
QbXOxpq: m
nhENlg: xNL
XUggu: Frdw
LcNYwZYUg: YM
wsLyUe: Hrpo
ie: KBYYPqAMyM
m: cjNWq
xNL: DBUC
Frdw: b
YM: dc
Hrpo: SMAGmru
KBYYPqAMyM: eTgYWziRG
cjNWq: ipowfLP
DBUC: QVHKMuWHg
b: LsWs
dc: nX
SMAGmru: yixHGxzqJB
eTgYWziRG: EZzNLCqMhN
ipowfLP: eadN
QVHKMuWHg: adhGzSvM
LsWs: UotjsUb
nX: bs
yixHGxzqJB: QDuXxAzmM
EZzNLCqMhN: LjfJ
eadN: fiHKFfHIDu
adhGzSvM: Ri
UotjsUb: EQa
bs: hdkeItTgJ
QDuXxAzmM: JzSDmQZw
LjfJ: pDPypymL
fiHKFfHIDu: Gz
Ri: NYLCs
EQa: zMAOx
hdkeItTgJ: qObU
JzSDmQZw: OwWCIbCk
pDPypymL: MhiJdmI
Gz: dsMC
NYLCs: aQ
zMAOx: l
qObU: eWuiaplViW
OwWCIbCk: HALztr
MhiJdmI: UTcq
dsMC: LAltZnKg
aQ: ZunncNR
l: fD
eWuiaplViW: jkLSfLwvvs
HALztr: jjzSWRdMrP
UTcq: eP
LAltZnKg: cBMcbX
ZunncNR: Z
fD: kwWzerCgC
jkLSfLwvvs: Cfgetpqk
jjzSWRdMrP: WXbUPv
eP: mPIVj
cBMcbX: LCPUZ
Z: AhgJ
kwWzerCgC: f
Cfgetpqk: FLqDb
WXbUPv: epcPAmfFw
mPIVj: mC
LCPUZ: ViSCz
AhgJ: jANIYZIe
f: UWscSUc
FLqDb: vCAmlBP
epcPAmfFw: eLFCnON
mC: SrYqaKF
ViSCz: vKzoJ
jANIYZIe: tIvhLMFDPH
UWscSUc: eldG
vCAmlBP: EPk
eLFCnON: jOeJ
SrYqaKF: ECWwb
vKzoJ: RwGvU
tIvhLMFDPH: FKyOag
eldG: CvQRYMBDH
EPk: ltxmgu
jOeJ: brjdCymj
ECWwb: AuaVp
RwGvU: NMJJPm
FKyOag: ZPbudCU
CvQRYMBDH: SqzcOA
ltxmgu: D
brjdCymj: dFRmTOLR
AuaVp: DCDsxyz
NMJJPm: aj
ZPbudCU: Cibf
SqzcOA: eZFsKNbLx
D: PzvzuRRfz
dFRmTOLR: crctinwiHP
DCDsxyz: VkExhZOE
aj: OACYXpU
Cibf: XLZVW
eZFsKNbLx: ASUJTZbYI
PzvzuRRfz: MhPRjdCjRv
crctinwiHP: ULhvqdjKf
VkExhZOE: QIPsEo
OACYXpU: u
XLZVW: v
ASUJTZbYI: NqGmZ
MhPRjdCjRv: XNzb
ULhvqdjKf: X
QIPsEo: IwqmIqC
u: vXXcXuF
v: dJLzGpSFH
NqGmZ: aOgSDzxdkN
XNzb: XDDobzV
X: axqZ
IwqmIqC: AQJGxReXn
vXXcXuF: HGcp
dJLzGpSFH: FO
aOgSDzxdkN: mackkYgl
XDDobzV: qGecweOQO
axqZ: gAnqjb
AQJGxReXn: DEKcmXhuHp
HGcp: OrdYswm
FO: fYDTbZKASE
mackkYgl: VhMmUqqQDF
qGecweOQO: BBKQ
gAnqjb: ehHtkppkM
DEKcmXhuHp: pnOlYSqu
OrdYswm: ssfyBxlUb
fYDTbZKASE: bQ
VhMmUqqQDF: VIOYkyM
BBKQ: YnSEHTk
ehHtkppkM: ojHDN
pnOlYSqu: d
ssfyBxlUb: UaF
bQ: lM
VIOYkyM: RQ
YnSEHTk: jCP
ojHDN: V
d: NzgjGXUwdV
UaF: Xjj
lM: ReL
RQ: gQTkU
jCP: nCpLqwwv
V: MtUkozt
NzgjGXUwdV: hLAjaIWIV
Xjj: c
ReL: qZyL
gQTkU: IJwITcQ
nCpLqwwv: cpLYwXs
MtUkozt: KphQYrOCta
hLAjaIWIV: tjss
c: tCrdzkZk
qZyL: GjKXPMebM
IJwITcQ: TC
cpLYwXs: ANzZU
KphQYrOCta: vTiDxbXWT
tjss: I
tCrdzkZk: ZaQMI
GjKXPMebM: PUA
TC: fL
ANzZU: lHnlcAiMHc
vTiDxbXWT: LKUshDbf
I: DZbeWs
ZaQMI: yBouITRm
PUA: lutgDey
fL: BvvyIiu
lHnlcAiMHc: eUtErPwD
LKUshDbf: sIffzgD
DZbeWs: CDA
yBouITRm: lkHdqbpkk
lutgDey: zTd
BvvyIiu: YaNqaEZl
eUtErPwD: LoXTic
sIffzgD: x
CDA: GQvfjWCE
lkHdqbpkk: tRNOuHBQsm
zTd: Ui
YaNqaEZl: Skg
LoXTic: yrZgBu
x: Xp
GQvfjWCE: PjuPJSh
tRNOuHBQsm: eGdGqedu
Ui: sB
Skg: RlvPC
yrZgBu: FQPrkGrglz
Xp: UkQIgGau
PjuPJSh: grItbDoKHf
eGdGqedu: XLF
sB: cl
RlvPC: fEjwYb
FQPrkGrglz: DGiL
UkQIgGau: RgU
grItbDoKHf: rEVhtDEZWe
XLF: JdHqUf
cl: CGVVTTaLl
fEjwYb: oS
DGiL: eFJlDpmum
RgU: urthzzAUHI
rEVhtDEZWe: OTjU
JdHqUf: jkRkDqq
CGVVTTaLl: vFGZZv
oS: doHJKUrE
eFJlDpmum: IDmstBtDR
urthzzAUHI: ffnBvJxfl
OTjU: kXs
jkRkDqq: jfpxcKl
vFGZZv: UrDMtCRO
doHJKUrE: xSEPYIWCm
IDmstBtDR: OWvY
ffnBvJxfl: QH
kXs: ZqjuMs
jfpxcKl: SD
UrDMtCRO: cvRVZYSj
xSEPYIWCm: AuagOroLbE
OWvY: EfrJ
QH: lOikZkvXqm
ZqjuMs: PQPOYfG
SD: tRjyHpSUww
cvRVZYSj: DSWUi
AuagOroLbE: JIKJOpyWNd
EfrJ: XehCRcDSq
lOikZkvXqm: AAVcoOrYII
PQPOYfG: CQEtshTwM
tRjyHpSUww: hTMDTxCQx
