ENCODE
aptaWmm: Sk JU Hf PhukLE XLdJjjJWaV sNxuRGFBkJ lhxRhp xgi NxBHOr vVZzy iYlH Qzhf eJ
Hf: jAPst
PhukLE: A
sNxuRGFBkJ: GWLMN
lhxRhp: vDITCBS
xgi: jzjUPrJqkR
NxBHOr: ZVOoU
vVZzy: W
iYlH: uxHwqw
Qzhf: VGhCgBzJcB
eJ: CdSAezctE
Sk: vMCR
JU: uuxMkD
XLdJjjJWaV: JZbsZL
jAPst: mGBEwUIz
A: tyNnBvwNO
GWLMN: kSG
vDITCBS: amr
jzjUPrJqkR: kymCFY
ZVOoU: nGTlUCUtop
W: TwFK
uxHwqw: YMhUps
VGhCgBzJcB: HhPb
CdSAezctE: rHBseK
vMCR: oKm
uuxMkD: UBhOK
JZbsZL: BIg
mGBEwUIz: DxLrRNKIi
tyNnBvwNO: calVAlr
kSG: mRTohUqHPb
amr: WLY
kymCFY: Fae
nGTlUCUtop: NFVTL
TwFK: Ubb
YMhUps: iDD
HhPb: lFzoTFoVAE
rHBseK: iizkeMFf
oKm: xkcpwWl
UBhOK: UrZoWvyft
BIg: dAVzLHOg
DxLrRNKIi: j
calVAlr: mcAXuSFhsN
mRTohUqHPb: GvfSooSxz
WLY: OAZeXA
Fae: XH
NFVTL: PALY
Ubb: yORFrBM
iDD: Bvy
lFzoTFoVAE: CE
iizkeMFf: q
xkcpwWl: OW
UrZoWvyft: fuTpQ
dAVzLHOg: aPRg
j: lSmodwwj
mcAXuSFhsN: DcHzbq
GvfSooSxz: KlcJFddEz
OAZeXA: FHNlTrzMcy
XH: SczJj
PALY: ewTjubQRtl
yORFrBM: VrQg
Bvy: vTUZherJn
CE: vZkiaggHp
q: Ulx
OW: DKcqpanEBh
fuTpQ: Qg
aPRg: CxsijWtMf
lSmodwwj: fFY
DcHzbq: siMDRcFdIE
KlcJFddEz: cmCruvL
FHNlTrzMcy: rztOGmAvn
SczJj: yDdsh
ewTjubQRtl: sWgS
VrQg: s
vTUZherJn: Rakp
vZkiaggHp: fUnKPYX
Ulx: GPA
DKcqpanEBh: KbWhU
Qg: OK
CxsijWtMf: DCyregawT
fFY: Zswwo
siMDRcFdIE: QL
cmCruvL: smGtezbr
rztOGmAvn: bEcxUTzBW
yDdsh: xnltOSZoch
sWgS: Ljlono
s: mZLFRgh
Rakp: hvs
fUnKPYX: cB
GPA: Pc
KbWhU: kbPeiQRB
OK: RfapnL
DCyregawT: nMszg
Zswwo: sQO
QL: YJWsG
smGtezbr: ySdUECqV
bEcxUTzBW: NnP
xnltOSZoch: NyTFcDmO
Ljlono: XtpIIA
mZLFRgh: UZXaGrBisb
hvs: qv
cB: LwkmHwAkn
Pc: pkwWgK
kbPeiQRB: qbOGW
RfapnL: yAKadH
nMszg: RVCVQrWPCW
sQO: yYxZCij
YJWsG: tpCRPIRd
ySdUECqV: dq
NnP: ZSVcYT
NyTFcDmO: y
XtpIIA: NaBLGmMg
UZXaGrBisb: uTxKPf
qv: pYiL
LwkmHwAkn: xS
pkwWgK: YD
qbOGW: QvOittYt
yAKadH: pJOe
RVCVQrWPCW: grNMYo
yYxZCij: ASdwaxQYL
tpCRPIRd: axFzjzKYAj
dq: LBRZYwesY
ZSVcYT: EtgqVVBjw
y: rcV
NaBLGmMg: TPYI
uTxKPf: BtV
pYiL: lRgmBC
xS: sWihEBIEfw
YD: brPFZQDK
QvOittYt: ECfSPiJ
pJOe: jNkOAiPHVM
grNMYo: ETDAuKrEQ
ASdwaxQYL: OreCn
axFzjzKYAj: FUEzSzOD
LBRZYwesY: BH
EtgqVVBjw: eBEklilH
rcV: RJakcwmaNs
TPYI: CVzrLh
BtV: R
lRgmBC: qAgV
sWihEBIEfw: mjWyfFtzc
brPFZQDK: OyLi
ECfSPiJ: BquekUwBE
jNkOAiPHVM: AfLgSWi
ETDAuKrEQ: yEevJDiEx
OreCn: RFRrWa
FUEzSzOD: qgePKOztH
BH: QfkOOe
eBEklilH: h
RJakcwmaNs: dkcMZNNV
CVzrLh: SSvPfK
R: C
qAgV: P
mjWyfFtzc: KEBIQ
OyLi: QKcYznFzL
BquekUwBE: VEW
AfLgSWi: IQPRLo
yEevJDiEx: YDDAO
RFRrWa: eTGGaPL
qgePKOztH: zGmIRxV
QfkOOe: NMGdURH
h: QyT
dkcMZNNV: QQ
SSvPfK: UyBGnFPb
C: kLvjTS
P: fHhmMT
KEBIQ: VZmdms
QKcYznFzL: CZkBw
VEW: eYj
IQPRLo: JJgMMxCETl
YDDAO: bu
eTGGaPL: WZBGPS
zGmIRxV: n
NMGdURH: iXM
QyT: QzOO
QQ: OnR
UyBGnFPb: uUOd
kLvjTS: Qb
fHhmMT: i
VZmdms: lved
CZkBw: ajAUW
eYj: nGxW
JJgMMxCETl: DsLKp
bu: bjtIpdtl
WZBGPS: PGIv
n: aNoV
iXM: U
QzOO: takPbOA
OnR: nPOt
uUOd: kGjRwRYrGW
Qb: ETV
i: tTEzZca
lved: ezNsPv
ajAUW: vv
nGxW: OP
DsLKp: ErkbbxfrzZ
bjtIpdtl: JfK
PGIv: qVXYbaHHxx
aNoV: DD
U: xV
takPbOA: IKFyiA
nPOt: VK
kGjRwRYrGW: sarUiu
ETV: nqsA
tTEzZca: Dwq
ezNsPv: ae
vv: TNcXHoD
OP: QRHht
ErkbbxfrzZ: wDcTSS
JfK: HUwdUQlK
qVXYbaHHxx: bv
DD: T
xV: didGPCz
IKFyiA: mqE
VK: rgTHgIWXJ
sarUiu: szlL
nqsA: LSRWTZHGW
Dwq: uAy
ae: pUZXqVn
TNcXHoD: WCyfK
QRHht: JiSWPAPKYj
wDcTSS: irnP
HUwdUQlK: II
bv: AU
T: FXfJuITXv
didGPCz: IMPtyUhqG
mqE: pOYakFq
rgTHgIWXJ: B
szlL: pBB
LSRWTZHGW: EfMF
uAy: Zs
pUZXqVn: lTS
WCyfK: gcnRnPXWVx
JiSWPAPKYj: a
irnP: qJJibEs
II: VaayS
AU: hhtuIKzqi
FXfJuITXv: Wnyut
IMPtyUhqG: wdTLFRvGXQ
pOYakFq: vJW
B: cPSTK
pBB: FpXoveKvd
EfMF: S
Zs: yB
lTS: ZCG
gcnRnPXWVx: HkiBzdJfMw
a: xpb
qJJibEs: AcuUWt
VaayS: wPChwo
hhtuIKzqi: H
Wnyut: AalD
wdTLFRvGXQ: yZmT
vJW: UqYSmYExHG
cPSTK: WmbXGNWPV
FpXoveKvd: SFRsGeFpR
S: JsO
yB: wzUD
ZCG: xF
HkiBzdJfMw: UeqtIlojer
xpb: kKa
AcuUWt: btlyDBYUQg
wPChwo: Pfaw
H: ZPmG
AalD: GYpWqe
yZmT: xnnARHg
UqYSmYExHG: PI
WmbXGNWPV: mhmjTff
SFRsGeFpR: fNGHUJYs
JsO: yNugb
wzUD: FriSWI
xF: sSCLOl
UeqtIlojer: eUmP
kKa: UcFxnuAaZ
btlyDBYUQg: uJwFB
Pfaw: Ttd
ZPmG: iXskxPHap
GYpWqe: BblZ
xnnARHg: YOa
PI: cDrbbc
mhmjTff: qHbDrtTDBu
fNGHUJYs: tNmInHaJ
yNugb: k
FriSWI: ckEFXBXdng
sSCLOl: pAzpIU
eUmP: PFjAiQrbn
UcFxnuAaZ: KkEIKa
uJwFB: iwEJNpLi
Ttd: ygk
iXskxPHap: YXLecQi
BblZ: VXUt
YOa: uFWIv
cDrbbc: MZ
qHbDrtTDBu: VOfAyKRwUN
tNmInHaJ: gCZwsGZSpj
k: UDXOqhT
ckEFXBXdng: BsRyfse
pAzpIU: nuuOzwPLC
PFjAiQrbn: PKwFnsY
KkEIKa: WexkCyJwJ
iwEJNpLi: FgIo
ygk: z
YXLecQi: yoOM
VXUt: eGvrwzA
uFWIv: BSHx
MZ: iqIwpBQ
VOfAyKRwUN: J
gCZwsGZSpj: TVWshcaJ
UDXOqhT: gnpQ
BsRyfse: xzDfZupQ
nuuOzwPLC: so
PKwFnsY: Rzfte
WexkCyJwJ: eGBFsgGh
FgIo: mGwgGYWgkz
z: Zvn
yoOM: tjwiUShOLm
eGvrwzA: EagWz
BSHx: o
iqIwpBQ: IkAgyYh
J: yPg
TVWshcaJ: mXSCQC
gnpQ: CGTCjFMUXm
xzDfZupQ: jdStwwW
so: BXOtSR
Rzfte: cfzv
eGBFsgGh: wutoIGX
mGwgGYWgkz: ZD
Zvn: Jo
tjwiUShOLm: egP
EagWz: w
o: iWdtiN
IkAgyYh: Y
yPg: QVNzLmyVK
mXSCQC: hOqZVUYC
CGTCjFMUXm: PfiZ
jdStwwW: tpUAYFNKJ
BXOtSR: sz
cfzv: gQf
wutoIGX: rEDWjGTDM
ZD: TficFNg
Jo: oYdJMio
egP: TipHRLgsd
w: VuPm
iWdtiN: OPARNBmFd
Y: DFK
QVNzLmyVK: F
hOqZVUYC: wWmFvtR
PfiZ: WmvxyPPrEb
tpUAYFNKJ: mpH
sz: BkjEUj
gQf: TDtFqm
rEDWjGTDM: DsnfIRkJP
TficFNg: MaJfbKaF
oYdJMio: ppjFWcY
TipHRLgsd: QYjDQdN
VuPm: CecBYPhGIy
OPARNBmFd: cz
DFK: t
F: jUEjnxOrKU
wWmFvtR: PY
WmvxyPPrEb: hz
mpH: ueixqXvUkZ
BkjEUj: HWapt
TDtFqm: rLdSJ
DsnfIRkJP: mmzNTRVjib
MaJfbKaF: jPNoH
ppjFWcY: Humu
QYjDQdN: uOkPPPSlce
CecBYPhGIy: MiCOwXBx
cz: m
t: GFNz
jUEjnxOrKU: fX
PY: vUVqfMn
hz: WWQPee
ueixqXvUkZ: MCuTRVTy
HWapt: wOUbtMqX
rLdSJ: XOxtWgKItz
mmzNTRVjib: DBRnb
jPNoH: b
Humu: zlEm
uOkPPPSlce: yzTq
MiCOwXBx: af
m: oOeazr
GFNz: ACNrmDcM
fX: K
vUVqfMn: RXIlAVuIP
WWQPee: hEsd
MCuTRVTy: aUzTlijsq
wOUbtMqX: meDqffxKb
XOxtWgKItz: VmvTYZBfS
DBRnb: FkC
b: bDHMYbJHNo
zlEm: PTLZCv
yzTq: CIJkU
af: EaeJi
oOeazr: iCaAPBa
ACNrmDcM: ylzVAuQiPx
K: ttpNku
RXIlAVuIP: oGaiXYZpOk
hEsd: Sp
aUzTlijsq: iLeEIZaORQ
meDqffxKb: VHfisDGos
VmvTYZBfS: mCimgohYwm
FkC: oTD
bDHMYbJHNo: NaCmrfrN
PTLZCv: HhKoNK
CIJkU: GS
EaeJi: BmuV
iCaAPBa: Z
ylzVAuQiPx: lqVgNZ
ttpNku: cY
oGaiXYZpOk: mDL
Sp: SPc
iLeEIZaORQ: TZdLtVVR
VHfisDGos: sWIvXaMFRJ
mCimgohYwm: oUt
oTD: Ie
NaCmrfrN: kZcU
HhKoNK: wcglDQmvbd
GS: UKtobZ
BmuV: HtqfBDXG
Z: gYUjuktC
lqVgNZ: f
cY: CjIiwvgbuM
mDL: Iwhva
SPc: MEg
TZdLtVVR: gXzo
sWIvXaMFRJ: upERH
oUt: FwAPgsnqA
Ie: yWdg
kZcU: ZlWSqfL
wcglDQmvbd: rVeNUgw
UKtobZ: mxxG
HtqfBDXG: SHDMYmEwfm
gYUjuktC: YwHLPqB
f: aPCvMI
CjIiwvgbuM: SNlSxy
Iwhva: Vdr
MEg: oUL
gXzo: IyQUnAgeE
upERH: g
FwAPgsnqA: eZvuupZ
yWdg: M
ZlWSqfL: Vb
rVeNUgw: D
mxxG: aZaVNWHt
SHDMYmEwfm: VgQgpqZeg
YwHLPqB: ElmDac
aPCvMI: giZovv
SNlSxy: CF
Vdr: ZOebcBzxT
oUL: IYSErqaCh
IyQUnAgeE: od
g: br
eZvuupZ: eG
M: tkxZQphgb
Vb: KsbzaOnHVG
D: IkahWclOl
aZaVNWHt: nMeQB
VgQgpqZeg: KytoVuv
ElmDac: DKCyK
giZovv: TPFCYpX
CF: u
ZOebcBzxT: v
IYSErqaCh: PUEKHypvrY
od: zCHVmu
br: YPcpB
eG: lukQBCOf
tkxZQphgb: sTVkdqJ
KsbzaOnHVG: vyChUjl
IkahWclOl: BWPHhqSmRP
nMeQB: kpIf
KytoVuv: GUBhHtm
DKCyK: bLM
TPFCYpX: brUMf
u: MqeUim
v: pncK
PUEKHypvrY: njzkbggnVE
zCHVmu: GCaT
YPcpB: Frqq
lukQBCOf: HlCnpT
sTVkdqJ: TwxKGLu
vyChUjl: kbVuKCEq
BWPHhqSmRP: DwYdIgj
kpIf: Ivx
GUBhHtm: Pies
bLM: AQOOswPKZo
brUMf: bReMqBRhI
MqeUim: NPysT
pncK: RoeROvcq
njzkbggnVE: HnJKHvn
GCaT: RAuQRv
Frqq: Te
HlCnpT: vbN
TwxKGLu: ZPfvzR
kbVuKCEq: IYsRmi
DwYdIgj: lvguxyq
Ivx: d
Pies: cAA
AQOOswPKZo: qEMNo
bReMqBRhI: fXj
NPysT: jnXgG
RoeROvcq: V
HnJKHvn: ybmSu
RAuQRv: IacMDnOg
Te: PVhIOg
vbN: OXDeFSIN
ZPfvzR: hmpAgxC
IYsRmi: tTHOeCPILx
lvguxyq: zujkGnxD
d: prw
cAA: CqVMgdySlE
qEMNo: zWS
fXj: RCrtD
jnXgG: Ys
V: WgeRfVv
ybmSu: c
IacMDnOg: ncEmkhVS
PVhIOg: ZgcPLNix
OXDeFSIN: jM
hmpAgxC: hmUwuOyx
tTHOeCPILx: XaQxCwXIb
zujkGnxD: ciC
prw: gXT
CqVMgdySlE: NiuQZaas
zWS: uiQPdsWf
RCrtD: APZ
Ys: ic
WgeRfVv: wWWdgPLMW
c: I
ncEmkhVS: ne
ZgcPLNix: VedSwxwLw
jM: BgrhhuLwh
hmUwuOyx: XFOE
XaQxCwXIb: lWaRr
ciC: Mwga
gXT: QmtrbrgzI
NiuQZaas: iePoYZdfK
uiQPdsWf: KNEgHfpw
APZ: azrSzM
ic: Reh
wWWdgPLMW: zgUoj
I: x
ne: G
VedSwxwLw: lKfF
BgrhhuLwh: kJqYUiaJcH
XFOE: fzDGiDZCK
lWaRr: VFzKUds
Mwga: esvMFw
QmtrbrgzI: Orzzx
iePoYZdfK: qCgclquOX
KNEgHfpw: PHlVdtdc
azrSzM: hoEBtYzvGA
Reh: NFwMmNVtM
zgUoj: iPzyATrOZB
x: zylMEnT
G: zoSFBH
lKfF: MONZkEhen
kJqYUiaJcH: fEkACdTRA
fzDGiDZCK: ugmeDSwQy
VFzKUds: evBrmnuICA
esvMFw: cUmtVDUIOs
Orzzx: gWhH
qCgclquOX: XtZPekj
PHlVdtdc: hymAevg
hoEBtYzvGA: lopPyh
NFwMmNVtM: hTTTq
iPzyATrOZB: NkVC
zylMEnT: lyv
zoSFBH: yfjHfl
MONZkEhen: utCyGMg
fEkACdTRA: uN
ugmeDSwQy: zSkEdPf
evBrmnuICA: biHYQe
cUmtVDUIOs: czEPd
gWhH: Pdun
XtZPekj: kIF
hymAevg: ps
lopPyh: oOhTN
hTTTq: KEcHUzC
NkVC: xogmtq
lyv: ttaYGrUg
yfjHfl: HHzYJ
utCyGMg: MDSVp
uN: wRSJw
zSkEdPf: nRbKKJvtk
biHYQe: wXsA
czEPd: owrmTfSKPA
Pdun: kSIvgU
