ENCODE
zYWSDGHgx: TWcEIXsPpH ejpWvP lBxxKx ZsbxZCnDn MKZ AcISFlfE IzXaSOnh hpCPAwgoL MVhINRQXnI tlNusKo JJ NvR gIZaNn uw ldEin zxQIf kSBsVzS czmvegTP
TWcEIXsPpH: A
ejpWvP: oVKCGvzU
lBxxKx: lLacseqQFF
ZsbxZCnDn: mqEJfRNlU
MKZ: RiE
IzXaSOnh: RiFNaacN
hpCPAwgoL: kknNCZSUPq
MVhINRQXnI: jUEmJqsbAE
JJ: ysWmBXG
NvR: VqvAxhEEX
gIZaNn: CjAtaVLVr
uw: dBDHHThMND
ldEin: LONNkHzfc
zxQIf: oRPVQzEk
kSBsVzS: mPJZdbzc
czmvegTP: IF
AcISFlfE: KlFhWgK
tlNusKo: cbIc
A: iRrIy
oVKCGvzU: LH
lLacseqQFF: FAyXt
mqEJfRNlU: sQXEXw
RiE: IfvMQfQzOA
RiFNaacN: wE
kknNCZSUPq: L
jUEmJqsbAE: EZYJTAYP
ysWmBXG: UzVU
VqvAxhEEX: FUI
CjAtaVLVr: gZ
dBDHHThMND: pqiqY
LONNkHzfc: kmZf
oRPVQzEk: JQDzxVT
mPJZdbzc: WpZl
IF: bzYRpsN
KlFhWgK: XDhU
cbIc: OCOaI
iRrIy: yIo
LH: rDl
FAyXt: rm
sQXEXw: j
IfvMQfQzOA: fyYePa
wE: rXlW
L: yeSfxM
EZYJTAYP: gDHlolJMrd
UzVU: AJCqz
FUI: q
gZ: gEjKp
pqiqY: NUgjlyuaxk
kmZf: lV
JQDzxVT: BxsKseys
WpZl: hNZQpMGT
bzYRpsN: PWaQdvsh
XDhU: sHdxCANYJ
OCOaI: zqSpB
yIo: MqcbxmSypg
rDl: Cbp
rm: s
j: kjtHJKuZ
fyYePa: fSCZ
rXlW: E
yeSfxM: aGRkurB
gDHlolJMrd: nbwvyw
AJCqz: qaVksDqD
q: UNjYhTjmm
gEjKp: rDqzU
NUgjlyuaxk: KNkzsbs
lV: adEamfATx
BxsKseys: BvP
hNZQpMGT: cOriemF
PWaQdvsh: dPntwlNZky
sHdxCANYJ: gSu
zqSpB: hcxscI
MqcbxmSypg: ltuBFGw
Cbp: HuExPa
s: bON
kjtHJKuZ: UvwHzb
fSCZ: vq
E: pS
aGRkurB: VzEDKyaqUt
nbwvyw: SZg
qaVksDqD: qTZ
UNjYhTjmm: pgem
rDqzU: MckCOD
KNkzsbs: yezueXAgru
adEamfATx: PYGnMbGNTU
BvP: zkUN
cOriemF: AuKu
dPntwlNZky: NOASJ
gSu: y
hcxscI: zKZi
ltuBFGw: laLaDQpRfB
HuExPa: COJCoWlKLA
bON: Hxm
UvwHzb: DhQsO
vq: GCVTC
pS: AvhxXJ
VzEDKyaqUt: FT
SZg: kaNsPsscLE
qTZ: EOqJTFwimZ
pgem: CeqK
MckCOD: NHvfgeC
yezueXAgru: FOfDI
PYGnMbGNTU: gpyBoB
zkUN: homO
AuKu: IhBcG
NOASJ: ifsZ
y: CWT
zKZi: ajSWPoQ
laLaDQpRfB: YxtzvNNm
COJCoWlKLA: qSJ
Hxm: KhK
DhQsO: nhTn
GCVTC: jbB
AvhxXJ: hK
FT: XCThfA
kaNsPsscLE: QnLd
EOqJTFwimZ: KZNtScd
CeqK: zkGyGvSfdW
NHvfgeC: gF
FOfDI: jiiZo
gpyBoB: ZTrbVrBt
homO: dzBCBxiOG
IhBcG: FzvdI
ifsZ: fnAvNVFcPq
CWT: aYmriXLE
ajSWPoQ: qwCLitr
YxtzvNNm: IjPSBC
qSJ: hsZw
KhK: EQEE
nhTn: oA
jbB: RMOIqXxu
hK: sgGZd
XCThfA: R
QnLd: QYGWXnAkGs
KZNtScd: fJzQFC
zkGyGvSfdW: wXfFEnrsuO
gF: FyjCvc
jiiZo: ZaglqrJCtu
ZTrbVrBt: h
dzBCBxiOG: EGNWB
FzvdI: TuBw
fnAvNVFcPq: zGBMhQ
aYmriXLE: dGUvPDcOVz
qwCLitr: aSHUYxo
IjPSBC: QksZhCqQq
hsZw: r
EQEE: awyjLTZ
oA: jXUbU
RMOIqXxu: kpAftEPfD
sgGZd: ZYbPUpb
R: DtxwDXtIVz
QYGWXnAkGs: ZDUYhvn
fJzQFC: za
wXfFEnrsuO: LuvDFdCQQs
FyjCvc: OrVEb
ZaglqrJCtu: vXVR
h: EOWpdivv
EGNWB: OpsO
TuBw: taxPw
zGBMhQ: qcIm
dGUvPDcOVz: iEC
aSHUYxo: hWe
QksZhCqQq: rZ
r: dmsJLRCa
awyjLTZ: PgB
jXUbU: GQuOsIaH
kpAftEPfD: ZpJzyqNK
ZYbPUpb: dNBur
DtxwDXtIVz: EztDENTMkZ
ZDUYhvn: WIVfEinawJ
za: n
LuvDFdCQQs: yMEV
OrVEb: QEfspTbb
vXVR: CzVesk
EOWpdivv: clKZlUHsS
OpsO: hrD
taxPw: BptoCWfx
qcIm: zOmjnpKdP
iEC: mrBtdJGhQU
hWe: Vgop
rZ: ZulLozh
dmsJLRCa: jMuY
PgB: iMZoJU
GQuOsIaH: i
ZpJzyqNK: TO
dNBur: nsvcLscZ
EztDENTMkZ: oihzbd
WIVfEinawJ: tQT
n: EBTI
yMEV: JjivXA
QEfspTbb: CCjYtlQFkG
CzVesk: QlnEiqcl
clKZlUHsS: LCRGrJ
hrD: nCvGljm
BptoCWfx: MxPydmEJ
zOmjnpKdP: kEbrAbPVS
mrBtdJGhQU: YQGU
Vgop: NYuZTNM
ZulLozh: IHSO
jMuY: HFUaN
iMZoJU: kpcBMutCGd
i: pEshkdmpB
TO: N
nsvcLscZ: BGSlFG
oihzbd: Vv
tQT: sVXQ
EBTI: SRZpcrHRyn
JjivXA: EkJ
CCjYtlQFkG: kSgwHEiyPD
QlnEiqcl: bv
LCRGrJ: rheOotj
nCvGljm: T
MxPydmEJ: vcZfw
kEbrAbPVS: LM
YQGU: FFGcSAZT
NYuZTNM: qNLXQjTEbd
IHSO: VEnjuP
HFUaN: wAKlZ
kpcBMutCGd: qtnQNageIa
pEshkdmpB: sGJdEKHXi
N: dGRkRiI
BGSlFG: JRC
Vv: HddRX
sVXQ: NwVDAoAaa
SRZpcrHRyn: heqMS
EkJ: XUG
kSgwHEiyPD: muFlf
bv: ht
rheOotj: pp
T: Cw
vcZfw: QVfNjRDt
LM: LhJsnrrJo
FFGcSAZT: OYcZT
qNLXQjTEbd: LFk
VEnjuP: B
wAKlZ: iFxVCamgub
qtnQNageIa: uMPdq
sGJdEKHXi: jrQMlMRjU
dGRkRiI: iZ
JRC: a
HddRX: WaTDBN
NwVDAoAaa: LGZAfwCYyD
heqMS: fyN
XUG: Vpc
muFlf: XkLGgqdC
ht: ZjxS
pp: xrkyAwRT
Cw: vAWtJBl
QVfNjRDt: wmQXnZsf
LhJsnrrJo: CeqJUqP
OYcZT: BPER
LFk: AcULl
B: QYNlR
iFxVCamgub: Lo
uMPdq: dpZGsW
jrQMlMRjU: lLb
iZ: rGxJ
a: FOuNvH
WaTDBN: yIFStqudRs
LGZAfwCYyD: BKRxeB
fyN: H
Vpc: ehZTw
XkLGgqdC: Vcqc
ZjxS: oMCUCmgjos
xrkyAwRT: gwZSKWp
vAWtJBl: NbNpvgtK
wmQXnZsf: HxFMpXZC
CeqJUqP: bB
BPER: vLYau
AcULl: PHlOC
QYNlR: et
Lo: PbYkoqJT
dpZGsW: RxN
lLb: LNTDsFgO
rGxJ: kz
FOuNvH: rrA
yIFStqudRs: Nr
BKRxeB: xNSsucT
H: ow
ehZTw: HRPtRJC
Vcqc: lhIqt
oMCUCmgjos: sazxvyoD
gwZSKWp: dV
NbNpvgtK: KapHvnmoZo
HxFMpXZC: ohYAGRoLk
bB: xKO
vLYau: rEhJ
PHlOC: XoKazSmUD
et: gIIbYwNx
PbYkoqJT: znMcJFWDnL
RxN: jO
LNTDsFgO: uazEsRNo
kz: ieJ
rrA: nmedY
Nr: BtcjTQqHI
xNSsucT: NLfMpTAky
ow: k
HRPtRJC: qaY
lhIqt: OaQpEAoDy
sazxvyoD: cLMUaR
dV: yPRMFSztO
KapHvnmoZo: SBKZEZMyf
ohYAGRoLk: oEiQGksz
xKO: p
rEhJ: xG
XoKazSmUD: nyzDhGSdA
gIIbYwNx: vRoxTVt
znMcJFWDnL: UhznVqU
jO: jRxnHL
uazEsRNo: fYDSNB
ieJ: dRWSxLL
nmedY: XlbQBvisg
BtcjTQqHI: DRAVcFApYF
NLfMpTAky: LkENK
k: iPqX
qaY: aeu
OaQpEAoDy: PaowhuVtl
cLMUaR: XXFfC
yPRMFSztO: LKZt
SBKZEZMyf: qb
oEiQGksz: FEmHDhKn
p: FtwwrK
xG: JM
nyzDhGSdA: RBGtANmnT
vRoxTVt: SATRi
UhznVqU: KlsGAS
jRxnHL: Q
fYDSNB: Pe
dRWSxLL: ownzOCDpU
XlbQBvisg: z
DRAVcFApYF: OxE
LkENK: HybYUXSXnZ
iPqX: XPzwrPMyFM
aeu: tdp
PaowhuVtl: qpuSE
XXFfC: J
LKZt: UzAeeb
qb: IgDLY
FEmHDhKn: NtwCiQQvM
FtwwrK: OUAES
JM: zm
RBGtANmnT: tXpxNH
SATRi: hvMkl
KlsGAS: EAyMW
Q: o
Pe: iVKSZM
ownzOCDpU: jzDasNuQoy
z: yg
OxE: WwwtTiCF
HybYUXSXnZ: xNM
XPzwrPMyFM: w
tdp: vGC
qpuSE: Y
J: UQ
UzAeeb: nXtpU
IgDLY: iwfkZQ
NtwCiQQvM: MXY
OUAES: quftRky
zm: Yrt
tXpxNH: QSHwUy
hvMkl: tkNjviXAMS
EAyMW: xwnVXqemZ
o: Oraqur
iVKSZM: EDbrvvgO
jzDasNuQoy: IrCaCer
yg: rgE
WwwtTiCF: VmQTDYf
xNM: zNcOZCxDH
w: kRlkCJ
vGC: SWvrVkx
Y: LGbJbqBC
UQ: t
nXtpU: Xlas
iwfkZQ: lZt
MXY: jds
quftRky: zbojNzc
Yrt: O
QSHwUy: kX
tkNjviXAMS: zWaBGERt
xwnVXqemZ: rnEibyTQzk
Oraqur: FHNXmSONUy
EDbrvvgO: BfL
IrCaCer: Pf
rgE: edOdliU
VmQTDYf: iW
zNcOZCxDH: KQmwS
kRlkCJ: hJGrloeilq
SWvrVkx: b
LGbJbqBC: Ld
t: rNXyiPLiav
Xlas: BBVff
lZt: PLvWIY
jds: TK
zbojNzc: oHylP
O: pxk
kX: hpiQaLEQ
zWaBGERt: BCPiTBIPO
rnEibyTQzk: K
FHNXmSONUy: zAcpLe
BfL: YJnlbak
Pf: Mag
edOdliU: UjwP
iW: Lc
KQmwS: vje
hJGrloeilq: jVaWzZq
b: dpgOYF
Ld: ueJBt
rNXyiPLiav: juoperHz
BBVff: vsC
PLvWIY: DjqJeEpS
TK: gmGIvdekP
oHylP: ItwCoIwwb
pxk: dtOYHRJaI
hpiQaLEQ: eP
BCPiTBIPO: HQs
K: Z
zAcpLe: mPITVoQqEN
YJnlbak: hVtfi
Mag: BGOF
UjwP: YVD
Lc: UnKp
vje: GhWIQevjvX
jVaWzZq: qwjHSh
dpgOYF: bcHDwgQzR
ueJBt: f
juoperHz: kY
vsC: SLQWhTq
DjqJeEpS: cIYkmJXjTJ
gmGIvdekP: Toa
ItwCoIwwb: qBuLHWnKnK
dtOYHRJaI: owgOWROtQ
eP: FdDLyMcxhX
HQs: rHDR
Z: ipo
mPITVoQqEN: Hm
hVtfi: luW
BGOF: MDDmK
YVD: IUenbv
UnKp: XLPTQ
GhWIQevjvX: nAiG
qwjHSh: RtW
bcHDwgQzR: vaG
f: An
kY: rvpgcAPdV
SLQWhTq: IaTeiK
cIYkmJXjTJ: cQEg
Toa: RPqlSmPXl
qBuLHWnKnK: qIlqRUxMKL
owgOWROtQ: g
FdDLyMcxhX: JaJWQpcL
rHDR: M
ipo: pDhay
Hm: D
luW: lbiuQ
MDDmK: BY
IUenbv: hh
XLPTQ: oHqUKGINyA
nAiG: waTpea
RtW: HzgS
vaG: ZRkxjr
An: u
rvpgcAPdV: RUlY
IaTeiK: ASgzLecLAg
cQEg: ufIaeGJRE
RPqlSmPXl: X
qIlqRUxMKL: BcifeDItF
g: zT
JaJWQpcL: JBRhoiWfta
M: DCk
pDhay: TBpmo
D: xdTgEDTyD
lbiuQ: StG
BY: wepMzF
hh: PDUUNVDq
oHqUKGINyA: JcoPwMU
waTpea: UHFI
HzgS: NAYdwOxGNj
ZRkxjr: RUVCxeluj
u: WWjlSUlK
RUlY: ILGsgkmLjM
ASgzLecLAg: YjX
ufIaeGJRE: znrAcjZCRv
X: aL
BcifeDItF: GmjVHJ
zT: UwetxiQE
JBRhoiWfta: qgZaj
DCk: TxGYCKArp
TBpmo: V
xdTgEDTyD: rJZ
StG: e
wepMzF: ltrJ
PDUUNVDq: qjBvTii
JcoPwMU: MbIG
UHFI: oqmDuxa
NAYdwOxGNj: c
RUVCxeluj: Vh
WWjlSUlK: kCWWxSms
ILGsgkmLjM: DoBlZiRHB
YjX: oSTy
znrAcjZCRv: XQ
aL: LDKgYm
GmjVHJ: IndHO
UwetxiQE: cSQ
qgZaj: lb
TxGYCKArp: hb
V: cYVgJK
rJZ: jqEYqMq
e: Dy
ltrJ: Tir
qjBvTii: uouYT
MbIG: vPUqdWmYtc
oqmDuxa: dCOqrVxyGo
c: rcAo
Vh: pyjNxk
kCWWxSms: mgdGa
DoBlZiRHB: IowByveyre
oSTy: JXqENUzh
XQ: orqxEMpKk
LDKgYm: Ekoz
IndHO: GzxPL
cSQ: RidLlus
lb: zyVhqHiKw
hb: WPnOxrByv
cYVgJK: yZxj
jqEYqMq: edUqdFjhXl
Dy: gETAetfu
Tir: TeZVOKz
uouYT: pUcK
vPUqdWmYtc: BTX
dCOqrVxyGo: jzk
rcAo: lckc
pyjNxk: nN
mgdGa: DtQYKgzUw
IowByveyre: SZBDfBT
JXqENUzh: zwjmEUaDjy
orqxEMpKk: VLYFwqA
Ekoz: mDnt
GzxPL: tH
RidLlus: YgReJIb
zyVhqHiKw: qWRpM
WPnOxrByv: KUnmY
yZxj: uHRoXy
edUqdFjhXl: MNvbMCIGC
gETAetfu: HImd
TeZVOKz: bQWtdwM
pUcK: RhURBD
BTX: TpbO
jzk: tbRDz
lckc: ww
nN: YbbVyFizl
DtQYKgzUw: PE
SZBDfBT: qtasYRqM
zwjmEUaDjy: CLQZmhiNt
VLYFwqA: ZrLs
mDnt: gtMHKaZUm
tH: JSCuqR
YgReJIb: ULyGfAqu
qWRpM: JaCW
KUnmY: jkokn
uHRoXy: agHwtNYf
MNvbMCIGC: EOTSqpcVoJ
HImd: pWGSNXhx
bQWtdwM: owLrapY
RhURBD: XbqaqG
TpbO: JKAs
tbRDz: ctYKJqw
ww: fzTDyemPr
YbbVyFizl: NrvGTeDlY
PE: iqRGH
qtasYRqM: zTCuyLtKe
CLQZmhiNt: UTK
ZrLs: KVXIN
gtMHKaZUm: LSSHVfezcF
JSCuqR: yY
ULyGfAqu: voaDp
JaCW: RYVZCm
jkokn: Jg
agHwtNYf: FEBv
EOTSqpcVoJ: YpPmauQiHr
pWGSNXhx: jUNPlqo
owLrapY: Gip
