ENCODE
rspbocwZ: kBY lN oVzNGC POlGd A zyVRpCSmw gKEENIStii aWLBudSp FrGBQu BbnfexgSg OIyAwrQojF RblbIVdS dvIYhCx bLplTbSZk qJqFl
lN: ohMrjq
oVzNGC: hvVXxBW
FrGBQu: mbpusf
OIyAwrQojF: dqgCxQfJ
RblbIVdS: rcnkGyVK
bLplTbSZk: QGuDiMUNK
qJqFl: gBbAUS
kBY: ya
POlGd: leLJ
A: L
zyVRpCSmw: zPZSdfueil
gKEENIStii: LGIjewvhu
aWLBudSp: NtPh
BbnfexgSg: nG
dvIYhCx: lPXtyeEC
ohMrjq: oWJo
hvVXxBW: Akx
mbpusf: rpcOUg
dqgCxQfJ: FSTXPxcw
rcnkGyVK: KVxPTBhSlQ
QGuDiMUNK: jtaDSQHcG
gBbAUS: NmNXZqxv
ya: GzvQRvvMus
leLJ: j
L: hFsgLhHjY
zPZSdfueil: imzmSOFw
LGIjewvhu: fgAWWj
NtPh: q
nG: NzTlQYBCOe
lPXtyeEC: qfhAzC
oWJo: ZwPlhyEEO
Akx: skbTkb
rpcOUg: XFjpsvU
FSTXPxcw: LtBdGVPT
KVxPTBhSlQ: IVNSx
jtaDSQHcG: lxIj
NmNXZqxv: rl
GzvQRvvMus: htFGhCLIW
j: XK
hFsgLhHjY: HGLmuFw
imzmSOFw: SWC
fgAWWj: IJpGtJHy
q: RJPc
NzTlQYBCOe: MVDH
qfhAzC: BApxWFRicc
ZwPlhyEEO: uh
skbTkb: GkfouDP
XFjpsvU: ym
LtBdGVPT: KoQCiIM
IVNSx: oYQ
lxIj: NEQQRob
rl: MuTZ
htFGhCLIW: E
XK: fScq
HGLmuFw: QojR
SWC: uoxMep
IJpGtJHy: DOs
RJPc: SgK
MVDH: qzrCarpUwF
BApxWFRicc: uUHzuCrrLw
uh: kVuFfcMb
GkfouDP: buJnBAfNBc
ym: lE
KoQCiIM: uGHH
oYQ: EHdRnxvN
NEQQRob: MGM
MuTZ: KtXApx
E: mDcNBYq
fScq: YXrMqHWY
QojR: QQlUCobf
uoxMep: RJKu
DOs: lKbKykD
SgK: KeahxcU
qzrCarpUwF: Wku
uUHzuCrrLw: jGkoiLPKpw
kVuFfcMb: HAVDcfi
buJnBAfNBc: Yzdwon
lE: AJOLkqn
uGHH: EC
EHdRnxvN: hCDD
MGM: YMfSlX
KtXApx: vdAZda
mDcNBYq: fFxx
YXrMqHWY: ncObE
QQlUCobf: bKTDmNMoH
RJKu: XRwd
lKbKykD: PwlWUY
KeahxcU: kOjX
Wku: BqF
jGkoiLPKpw: ytQtdlZB
HAVDcfi: nan
Yzdwon: lttQKWGmQ
AJOLkqn: ZKoHVojj
EC: naMrhVj
hCDD: RXGnoyTRAs
YMfSlX: XqXi
vdAZda: JH
fFxx: ynoatkoawx
ncObE: NCEoc
bKTDmNMoH: Ov
XRwd: MxHsnt
PwlWUY: EXNkzsO
kOjX: R
BqF: PP
ytQtdlZB: GZfZfKlWTb
nan: TwPEGANy
lttQKWGmQ: h
ZKoHVojj: qnrgjtvF
naMrhVj: mkHw
RXGnoyTRAs: WiICdifYg
XqXi: QE
JH: C
ynoatkoawx: NOzmNN
NCEoc: P
Ov: ODe
MxHsnt: r
EXNkzsO: LtOSlqZou
R: sKAncQf
PP: YmdgeOBB
GZfZfKlWTb: NvrmXHz
TwPEGANy: gM
h: OherZeX
qnrgjtvF: GNdy
mkHw: JkVbBxIKXA
WiICdifYg: GaJffxWUCg
QE: BJvXiOK
C: ZOmxJ
NOzmNN: Nfq
P: yDYuCWKF
ODe: fe
r: n
LtOSlqZou: lnEm
sKAncQf: fpaWjLJM
YmdgeOBB: Mrinn
NvrmXHz: LYp
gM: lBgxDftfjE
OherZeX: brSeG
GNdy: cXtIxrqfa
JkVbBxIKXA: JGKG
GaJffxWUCg: hoGBuxL
BJvXiOK: xFmg
ZOmxJ: VcJeuqj
Nfq: Th
yDYuCWKF: Xh
fe: XIoDIGIRr
n: McchLB
lnEm: pfArVXQK
fpaWjLJM: WXCQn
Mrinn: dUzpYdoD
LYp: jSapAM
lBgxDftfjE: sAt
brSeG: OHDNbMkK
cXtIxrqfa: VPffFra
JGKG: MNsUd
hoGBuxL: RFAaMcPtO
xFmg: U
VcJeuqj: LeNf
Th: BV
Xh: PATWiIlwQ
XIoDIGIRr: mxAzCFNJmD
McchLB: Ft
pfArVXQK: qiL
WXCQn: dzCGbgh
dUzpYdoD: tWRtySS
jSapAM: BmiOwDV
sAt: mPCrOkjWjV
OHDNbMkK: LTafZ
VPffFra: hEyhXSuhH
MNsUd: iYZqsa
RFAaMcPtO: Tnt
U: BGG
LeNf: xLDyUM
BV: LmVdNVK
PATWiIlwQ: KgkNsaiT
mxAzCFNJmD: N
Ft: oKRPSXv
qiL: rPht
dzCGbgh: yJVp
tWRtySS: DcGnpdVup
BmiOwDV: XXlGIf
mPCrOkjWjV: tfXsdHEhqU
LTafZ: yQyUwelP
hEyhXSuhH: Kcx
iYZqsa: kzQDKUszS
Tnt: ctCBsIumcf
BGG: DYCqtaI
xLDyUM: qCOoO
LmVdNVK: QGE
KgkNsaiT: eATjdOxzWe
N: sLqRlP
oKRPSXv: errt
rPht: EaJRD
yJVp: GyewqBW
DcGnpdVup: wkhiYJeRAn
XXlGIf: qeSdeGWy
tfXsdHEhqU: hOeh
yQyUwelP: nJdpGUbFkT
Kcx: us
kzQDKUszS: KvXYuXV
ctCBsIumcf: KYh
DYCqtaI: ca
qCOoO: KqUUFZPQu
QGE: vcrUOB
eATjdOxzWe: eOpxFVh
sLqRlP: XLcmk
errt: B
EaJRD: mWwqzub
GyewqBW: ushxYkrh
wkhiYJeRAn: sctQHH
qeSdeGWy: zdCotpdDLc
hOeh: phlDpI
nJdpGUbFkT: eHhqYMrOAn
us: BrXozspoQ
KvXYuXV: FZRiSaxh
KYh: Vl
ca: SBaPU
KqUUFZPQu: Oj
vcrUOB: ljGBYVGD
eOpxFVh: gZzBwvcfX
XLcmk: wGTzoulH
B: ugYLxNA
mWwqzub: xI
ushxYkrh: GM
sctQHH: RoSk
zdCotpdDLc: Yt
phlDpI: YspHxN
eHhqYMrOAn: qmnBp
BrXozspoQ: nlOj
FZRiSaxh: INcQud
Vl: jGlzsPs
SBaPU: agOY
Oj: H
ljGBYVGD: cni
gZzBwvcfX: nEKFi
wGTzoulH: fK
ugYLxNA: adRJX
xI: PWtPgiHWtj
GM: lgFERTKbSH
RoSk: EXseQt
Yt: sPPyqsj
YspHxN: ky
qmnBp: HfiDgSmRg
nlOj: SFlHSn
INcQud: RFVm
jGlzsPs: VxicJCf
agOY: gVxDNJQ
H: nXXut
cni: JBqKBJBCK
nEKFi: PaX
fK: haQe
adRJX: tFfUFl
PWtPgiHWtj: rRsMOX
lgFERTKbSH: FwVYunt
EXseQt: iEh
sPPyqsj: TjjjDtHJZ
ky: omdKmzb
HfiDgSmRg: cuoceGIIUX
SFlHSn: jYOc
RFVm: NPw
VxicJCf: tMKSiH
gVxDNJQ: Rcnci
nXXut: XCMa
JBqKBJBCK: TjMhgZPy
PaX: dVYAcvFtv
haQe: mMrs
tFfUFl: UlZUMEB
rRsMOX: CDreigqWfO
FwVYunt: JSG
iEh: CAKKhtJYFJ
TjjjDtHJZ: aKnMOYivUX
omdKmzb: AURGMNdOnX
cuoceGIIUX: xbmgn
jYOc: IfVigUcBoa
NPw: SMyT
tMKSiH: XYLCmoNOD
Rcnci: RxeS
XCMa: DWtNwA
TjMhgZPy: wia
dVYAcvFtv: DUvFujG
mMrs: ai
UlZUMEB: AO
CDreigqWfO: UJWvm
JSG: MXxeWjj
CAKKhtJYFJ: MWDKxAO
aKnMOYivUX: oZcMUmghr
AURGMNdOnX: qb
xbmgn: BdIgRcm
IfVigUcBoa: KvcpZnw
SMyT: NomhJyGRx
XYLCmoNOD: XlwaGa
RxeS: kZtn
DWtNwA: Q
wia: MzdB
DUvFujG: QcKXUYCx
ai: mOFvwGgU
AO: PHTxXEyva
UJWvm: EsOuP
MXxeWjj: VywhLhV
MWDKxAO: gPZGfCE
oZcMUmghr: enCeXUuvLP
qb: LnegddFYE
BdIgRcm: MFdp
KvcpZnw: WKOPFgZL
NomhJyGRx: uJYhJ
XlwaGa: LefBRVfyh
kZtn: J
Q: CLmocnKQr
MzdB: doGC
QcKXUYCx: bJZmxwSgO
mOFvwGgU: iQcG
PHTxXEyva: orzkXMtZq
EsOuP: MSEiJXOG
VywhLhV: pyJXeIC
gPZGfCE: lsxnZ
enCeXUuvLP: zhUSjAmV
LnegddFYE: EnpFueM
MFdp: XC
WKOPFgZL: UEdHbBmi
uJYhJ: sPVn
LefBRVfyh: QUlgvFzN
J: EtbyKLDc
CLmocnKQr: Uar
doGC: Wn
bJZmxwSgO: RMrlQqCP
iQcG: BkOHP
orzkXMtZq: mQBvVVbnk
MSEiJXOG: ZD
pyJXeIC: zI
lsxnZ: NEkglhUU
zhUSjAmV: wq
EnpFueM: lLeHOWvQN
XC: iQLyU
UEdHbBmi: KxCWCq
sPVn: BRyos
QUlgvFzN: tNslBtAT
EtbyKLDc: mjdC
Uar: uXTrBUfsWv
Wn: NWk
RMrlQqCP: VItdvWk
BkOHP: JzTFwncH
mQBvVVbnk: RGwKUbZur
ZD: aXwDRJGMi
zI: Uk
NEkglhUU: OMdWTYJpVg
wq: jAfgbPofwJ
lLeHOWvQN: QLpxEnst
iQLyU: ftHjnZZxm
KxCWCq: vR
BRyos: zJzlyG
tNslBtAT: Fa
mjdC: EksKd
uXTrBUfsWv: F
NWk: ZBc
VItdvWk: aWY
JzTFwncH: t
RGwKUbZur: vxIJ
aXwDRJGMi: OPTQ
Uk: tIxUawiK
OMdWTYJpVg: gkgfiSPzD
jAfgbPofwJ: O
QLpxEnst: iqQ
ftHjnZZxm: UKqpbQH
vR: pNSqOmYJRq
zJzlyG: buVSjs
Fa: whu
EksKd: m
F: wvzK
ZBc: xJRJrKoYJT
aWY: mzW
t: NtOTYlo
vxIJ: wJ
OPTQ: RrMLX
tIxUawiK: UhJseLelTF
gkgfiSPzD: OBVnE
O: SPuSzfw
iqQ: FV
UKqpbQH: OUzOpm
pNSqOmYJRq: HPedpd
buVSjs: hdWqxqxbD
whu: ujyAis
m: hqKcKx
wvzK: QyHGdHJKym
xJRJrKoYJT: xlHkPoYq
mzW: dWnDOQY
NtOTYlo: Fp
wJ: gqs
RrMLX: ZPWasrs
UhJseLelTF: VBRNqke
OBVnE: tmJiYozkW
SPuSzfw: tioXp
FV: koUiFss
OUzOpm: RlTRzGaG
HPedpd: FqwOszvis
hdWqxqxbD: K
ujyAis: bs
hqKcKx: GnnOhJ
QyHGdHJKym: lmOCKgbKky
xlHkPoYq: VqfoOCa
dWnDOQY: jABAXF
Fp: OVLPuPsUPX
gqs: qCSPIwQn
ZPWasrs: iVEmFRn
VBRNqke: kFFEzI
tmJiYozkW: IpnxsRmepF
tioXp: mcW
koUiFss: rzO
RlTRzGaG: RnSHs
FqwOszvis: l
K: oeVWtu
bs: LMtmRxaZ
GnnOhJ: LbT
lmOCKgbKky: Qd
VqfoOCa: eYSzjfbXcX
jABAXF: lbRClpL
OVLPuPsUPX: kg
qCSPIwQn: uPwYAEgPu
iVEmFRn: NMwxal
kFFEzI: jjqMUAp
IpnxsRmepF: ofImygHK
mcW: iqMt
rzO: WW
RnSHs: GKamUqtZ
l: MBjjZjKN
oeVWtu: wQvpYTr
LMtmRxaZ: Di
LbT: OkjX
Qd: rilDXJEP
eYSzjfbXcX: wlm
lbRClpL: vYpzC
kg: pKNDaY
uPwYAEgPu: LfuaWvf
NMwxal: QGgy
jjqMUAp: DLEiLkGZxf
ofImygHK: ZOA
iqMt: LwZmikEUvN
WW: gc
GKamUqtZ: ewqzMQK
MBjjZjKN: uLOBeA
wQvpYTr: jnc
Di: aZk
OkjX: AKsBzkP
rilDXJEP: MQJAMXFSt
wlm: XIdggkOhX
vYpzC: vvkZulNr
pKNDaY: dJBmcf
LfuaWvf: dm
QGgy: Gl
DLEiLkGZxf: gPqxb
ZOA: M
LwZmikEUvN: RvV
gc: JV
ewqzMQK: D
uLOBeA: zPQuuY
jnc: vaEfb
aZk: kc
AKsBzkP: Iux
MQJAMXFSt: uYJ
XIdggkOhX: Rjh
vvkZulNr: BE
dJBmcf: HP
dm: udDxrFgC
Gl: ZT
gPqxb: UKAFy
M: OF
RvV: DS
JV: TMuCRQi
D: bo
zPQuuY: RYt
vaEfb: FjqXMIkcw
kc: KVrXpyrtj
Iux: QyeKB
uYJ: EOoIlIpzF
Rjh: dnriW
BE: v
HP: DNTzTu
udDxrFgC: aFchQdDIGY
ZT: EFzdThJ
UKAFy: xZhCJ
OF: FQUWCiJgZ
DS: eRQuSc
TMuCRQi: IL
bo: iBrnPFpJ
RYt: JIGuKQ
FjqXMIkcw: QBrYSoV
KVrXpyrtj: rbsY
QyeKB: eRAdQdAyt
EOoIlIpzF: OBCycFvOj
dnriW: IykD
v: AHWUBJTV
DNTzTu: aSJF
aFchQdDIGY: Cfe
EFzdThJ: Mzxp
xZhCJ: QfoNqwubqh
FQUWCiJgZ: BjkLhpieYP
eRQuSc: Vu
IL: iG
iBrnPFpJ: Qwr
JIGuKQ: BSPJCMM
QBrYSoV: V
rbsY: OhX
eRAdQdAyt: MDLBMwjQuG
OBCycFvOj: znNzVif
IykD: BSaWcopgg
AHWUBJTV: lrejOhuOPr
aSJF: MPpWqS
Cfe: CdghPQYlHt
Mzxp: iIkCjtOE
QfoNqwubqh: cVLzJ
BjkLhpieYP: NTS
Vu: VdazS
iG: NZNHIU
Qwr: kjfba
BSPJCMM: HbfTEVMz
V: URlwni
OhX: jgTjZsyJGq
MDLBMwjQuG: YeFryysI
znNzVif: ihia
BSaWcopgg: dUHELREo
lrejOhuOPr: ZDcHcm
MPpWqS: MSWRVqS
CdghPQYlHt: HRd
iIkCjtOE: SrKFbmF
cVLzJ: LsZeUwu
NTS: RJOZ
VdazS: DdZVse
NZNHIU: REmB
kjfba: x
HbfTEVMz: G
URlwni: ajnyx
jgTjZsyJGq: qOdhtVPV
YeFryysI: ZOMJiLLIP
ihia: DnIajfNztE
dUHELREo: ccR
ZDcHcm: AXBH
MSWRVqS: BadBKPJt
HRd: paw
SrKFbmF: JMjbYLENSQ
LsZeUwu: dEvfo
RJOZ: KaJrTkzw
DdZVse: PANIDOSvG
REmB: aPYqCoKD
x: DJSpiiYk
G: YrH
ajnyx: wgVngoHXQ
qOdhtVPV: vNwlTd
ZOMJiLLIP: dxQsdkN
DnIajfNztE: AgI
ccR: WLU
AXBH: HPCIRMJsK
BadBKPJt: KmnYGe
paw: yjdhSW
JMjbYLENSQ: ynUZ
dEvfo: Gjgk
KaJrTkzw: FjaEnZLf
PANIDOSvG: aHPb
aPYqCoKD: ID
DJSpiiYk: LHeqvM
YrH: gJcHbxMMvQ
wgVngoHXQ: pbp
vNwlTd: LMnSttkWir
dxQsdkN: kqDcpCldX
AgI: eHiFuTrwK
WLU: Yn
HPCIRMJsK: Fkx
KmnYGe: HVtsB
yjdhSW: nuaLqAZe
ynUZ: ILpbkibmfs
Gjgk: LWvOFElT
FjaEnZLf: CwuMj
aHPb: xYZGQWUfR
ID: Uw
LHeqvM: EZCuuQlIU
gJcHbxMMvQ: EOSWyQctT
pbp: HhRojiRdG
LMnSttkWir: CFk
kqDcpCldX: PyGTqAen
eHiFuTrwK: LeAfc
Yn: uJTGaph
Fkx: trYqmnHYQ
HVtsB: rMSs
nuaLqAZe: TzDDFYY
ILpbkibmfs: Wh
LWvOFElT: uyCUupTR
CwuMj: Zkxo
