ENCODE
zmqJYvS: cguS ZIleB ARFxLjW aLBjc hkaSb TCDoKq JoRC
cguS: OirgbnRWQ
ZIleB: bwevDlGYRG
ARFxLjW: UWriPChX
aLBjc: JEmeYkMT
hkaSb: LCAPN
TCDoKq: A
JoRC: bsAmzNIVri
OirgbnRWQ: yVXngZgbwO
bwevDlGYRG: RBtvO
UWriPChX: FdJA
JEmeYkMT: aUdN
LCAPN: sPb
A: W
bsAmzNIVri: ZRwOtmt
yVXngZgbwO: AHiyKrk
RBtvO: TDtwBOJeHY
FdJA: VxXZzE
aUdN: AyjOBxsBK
sPb: SanjdpSfHy
W: MbXJDIrq
ZRwOtmt: ripvwwByil
AHiyKrk: SZw
TDtwBOJeHY: kcjcWjFvtX
VxXZzE: UU
AyjOBxsBK: ZTjtAYwa
SanjdpSfHy: HzxWIZQcMQ
MbXJDIrq: gqfy
ripvwwByil: ipnjj
SZw: uzQ
kcjcWjFvtX: GiQsyNvRI
UU: RcCCDJ
ZTjtAYwa: ScgY
HzxWIZQcMQ: teKvXPHE
gqfy: sgTaZay
ipnjj: qYtupd
uzQ: XQtP
GiQsyNvRI: FlqwEBByzb
RcCCDJ: lKvmefM
ScgY: QOz
teKvXPHE: L
sgTaZay: agP
qYtupd: fVVeNews
XQtP: aSM
FlqwEBByzb: IgaRTP
lKvmefM: XqV
QOz: pPOfbCVJwk
L: j
agP: beF
fVVeNews: viwOuY
aSM: FSqILBXkZY
IgaRTP: HlJ
XqV: UF
pPOfbCVJwk: Ga
j: pUoq
beF: uuzAoQRmx
viwOuY: ntYqGGcMob
FSqILBXkZY: EvDHEPQ
HlJ: sQhj
UF: MKwoCeiCFQ
Ga: EvEzMoX
pUoq: vOwaUiho
uuzAoQRmx: mMRYCD
ntYqGGcMob: PUUfsaLP
EvDHEPQ: s
sQhj: ZCtKAKB
MKwoCeiCFQ: SIJt
EvEzMoX: nxvF
vOwaUiho: E
mMRYCD: WpwJttE
PUUfsaLP: IR
s: GfxTkiJJAe
ZCtKAKB: beDlEEn
SIJt: QGFsED
nxvF: XEqkHzlT
E: lnqMRb
WpwJttE: MwuhiKy
IR: DZ
GfxTkiJJAe: VW
beDlEEn: cMWqzyDGo
QGFsED: vzBbYMl
XEqkHzlT: FnX
lnqMRb: dtm
MwuhiKy: cwUaQNjjDl
DZ: WfVzHNHFu
VW: UJFbdg
cMWqzyDGo: JiVmd
vzBbYMl: ajjIBKCF
FnX: rWQoIUGW
dtm: lrbNE
cwUaQNjjDl: CDxhaXqDTE
WfVzHNHFu: BxNvWzj
UJFbdg: PhifG
JiVmd: jeyRkxELd
ajjIBKCF: grf
rWQoIUGW: MXosK
lrbNE: sn
CDxhaXqDTE: rUklfAAj
BxNvWzj: xA
PhifG: stqSFa
jeyRkxELd: tewe
grf: TB
MXosK: SIsw
sn: NFKQxVp
rUklfAAj: LUL
xA: bKJfB
stqSFa: GwbWJW
tewe: y
TB: ViDpGK
SIsw: rhCrdve
NFKQxVp: NSnZkmE
LUL: IfPMjIqm
bKJfB: VC
GwbWJW: xc
y: YFJBYA
ViDpGK: igLoUwfW
rhCrdve: kKqsYXKP
NSnZkmE: QUVYDRskpn
IfPMjIqm: TUHxZD
VC: YJztzWey
xc: ueMoc
YFJBYA: DtjrGd
igLoUwfW: WHOTA
kKqsYXKP: lbHy
QUVYDRskpn: FJ
TUHxZD: gRcS
YJztzWey: BuEsTcJS
ueMoc: SkPyRZCde
DtjrGd: DNwIScY
WHOTA: ZWCrxeg
lbHy: sFT
FJ: uD
gRcS: OQImlyZ
BuEsTcJS: CIyGvNMu
SkPyRZCde: R
DNwIScY: QiceVccLCU
ZWCrxeg: mNGo
sFT: CkY
uD: EfSORudmlb
OQImlyZ: nKpdzvY
CIyGvNMu: XTyGFF
R: nPDe
QiceVccLCU: h
mNGo: umT
CkY: SividmXC
EfSORudmlb: HCe
nKpdzvY: EHFMmXZK
XTyGFF: tRLHP
nPDe: XWMplB
h: P
umT: sKK
SividmXC: WYyqkmIKT
HCe: r
EHFMmXZK: qJkdrQU
tRLHP: EVnQGaVv
XWMplB: oDpRYH
P: uRoNIBHL
sKK: qZY
WYyqkmIKT: AZllGfJXue
r: MTSoT
qJkdrQU: Skzy
EVnQGaVv: DGXG
oDpRYH: DX
uRoNIBHL: ocFF
qZY: txzhvtRYpY
AZllGfJXue: wOXo
MTSoT: McSoVXfA
Skzy: PTEFf
DGXG: ndNOMRhjfJ
DX: uvf
ocFF: n
txzhvtRYpY: epfWnFkn
wOXo: PPMM
McSoVXfA: WTA
PTEFf: rhRLoAXPfx
ndNOMRhjfJ: EwfBmbrYZd
uvf: Ph
n: dSqT
epfWnFkn: pvHMoPkOA
PPMM: SCrXEEzG
WTA: wrgphAX
rhRLoAXPfx: ePbGAlAQ
EwfBmbrYZd: gQmONHhKyk
Ph: yIRU
dSqT: i
pvHMoPkOA: fZvRbRpjgV
SCrXEEzG: uBHUMF
wrgphAX: yjovvEGcw
ePbGAlAQ: aLhM
gQmONHhKyk: wCu
yIRU: cHoeqoWo
i: U
fZvRbRpjgV: QgzUaJ
uBHUMF: TOLocIQi
yjovvEGcw: LcY
aLhM: GNal
wCu: mTN
cHoeqoWo: sXuzlVxZUY
U: Ahkh
QgzUaJ: dHRcZubsl
TOLocIQi: JCzeN
LcY: pK
GNal: asDSGw
mTN: fYt
sXuzlVxZUY: NPi
Ahkh: waxmlIqo
dHRcZubsl: qMEiUj
JCzeN: CDVmfTv
pK: CmQtrQgV
asDSGw: XzlKHko
fYt: luDl
NPi: N
waxmlIqo: BsOR
qMEiUj: cL
CDVmfTv: hgXlAESey
CmQtrQgV: RilVwXt
XzlKHko: pSuQgxf
luDl: eaFyY
N: TuiSFJNrmZ
BsOR: drBtZnktT
cL: CIuIPo
hgXlAESey: DnhNRWgXvq
RilVwXt: GnB
pSuQgxf: AaQOFNGVci
eaFyY: FgTavtt
TuiSFJNrmZ: qI
drBtZnktT: vN
CIuIPo: FCwCqkpH
DnhNRWgXvq: pjC
GnB: tP
AaQOFNGVci: nzhafC
FgTavtt: kIHsT
qI: ddzJ
vN: mv
FCwCqkpH: xGPI
pjC: pU
tP: imlCWWjTDA
nzhafC: uXxQiIkMo
kIHsT: nOoUMoBN
ddzJ: B
mv: reQBHzSWHT
xGPI: iUJcPWM
pU: YOYxt
imlCWWjTDA: MwrrH
uXxQiIkMo: SFhBoaGs
nOoUMoBN: kUutkO
B: a
reQBHzSWHT: WhPfJ
iUJcPWM: rPYG
YOYxt: HxswYQeAq
MwrrH: QM
SFhBoaGs: PuAjhTCp
kUutkO: iJmCRT
a: S
WhPfJ: pxFuoqgR
rPYG: EUSrvGWTA
HxswYQeAq: zSVevo
QM: tXpphDr
PuAjhTCp: BTUjgd
iJmCRT: H
S: lRhAITsPp
pxFuoqgR: YEEQEPxxhp
EUSrvGWTA: hJNAFDMrQ
zSVevo: LRnKFKy
tXpphDr: BKJkZcVdct
BTUjgd: crjKNyP
H: rq
lRhAITsPp: gWnz
YEEQEPxxhp: AXW
hJNAFDMrQ: CV
LRnKFKy: TCOODonQu
BKJkZcVdct: Vc
crjKNyP: rNAy
rq: Sq
gWnz: GikWWiykwy
AXW: eamF
CV: PJBSmq
TCOODonQu: JJRRi
Vc: vLb
rNAy: lyt
Sq: qGZgITITR
GikWWiykwy: hkb
eamF: vqodTAexM
PJBSmq: Js
JJRRi: Fmvg
vLb: XhCJ
lyt: UxEonQyQ
qGZgITITR: mENzHGmg
hkb: wIeDs
vqodTAexM: k
Js: KHAOL
Fmvg: mRRNXjyBs
XhCJ: WvsB
UxEonQyQ: ESPc
mENzHGmg: uXC
wIeDs: Q
k: MRSSI
KHAOL: OJJ
mRRNXjyBs: z
WvsB: DREOWuok
ESPc: ShiqrZt
uXC: vda
Q: JIxcmR
MRSSI: IFQ
OJJ: ImGYJEPn
z: J
DREOWuok: iPpk
ShiqrZt: xbKD
vda: QekgarR
JIxcmR: ULHtCz
IFQ: SsxZPEmgS
ImGYJEPn: Fcqzslt
J: SbdNZJyjk
iPpk: BxvnXreon
xbKD: sZNSEQ
QekgarR: gaNNkYwTMT
ULHtCz: o
SsxZPEmgS: Bo
Fcqzslt: qD
SbdNZJyjk: XFFQdhhjlH
BxvnXreon: kXy
sZNSEQ: dj
gaNNkYwTMT: bPRQVt
o: We
Bo: OmmLNDSVkW
qD: xY
XFFQdhhjlH: hOlbzfwxjS
kXy: zZHsAGSn
dj: ZD
bPRQVt: dnycP
We: IuOZuVAGJ
OmmLNDSVkW: YCma
xY: XSxZrwB
hOlbzfwxjS: BsTWeo
zZHsAGSn: xs
ZD: w
dnycP: rQVZGkgnn
IuOZuVAGJ: HZoZ
YCma: UuWzi
XSxZrwB: XG
BsTWeo: ufLmaAnKnR
xs: IXugzFmZn
w: ZRaJaY
rQVZGkgnn: RspKXq
HZoZ: bnGfSp
UuWzi: uDaYNHnXQI
XG: ZBA
ufLmaAnKnR: Fa
IXugzFmZn: QIr
ZRaJaY: pDIEEZEcI
RspKXq: nVqncDEl
bnGfSp: mZgjpBD
uDaYNHnXQI: PWTzqdrZml
ZBA: ikbqYQzR
Fa: hrwj
QIr: rcIc
pDIEEZEcI: fl
nVqncDEl: kEmeJZh
mZgjpBD: xBPImVVgAM
PWTzqdrZml: Jq
ikbqYQzR: oMQIf
hrwj: iCCdJJCjHg
rcIc: eajGZSP
fl: iUzfdFwOJb
kEmeJZh: RWDS
xBPImVVgAM: m
Jq: adEps
oMQIf: zlKNspmUk
iCCdJJCjHg: tVJZXbA
eajGZSP: KB
iUzfdFwOJb: Qnmk
RWDS: DDkbRt
m: aMOTVr
adEps: OuyOv
zlKNspmUk: PlVHrkEpx
tVJZXbA: wxf
KB: fInqMnil
Qnmk: qW
DDkbRt: Va
aMOTVr: oASAIfvJKd
OuyOv: NXRoYjsb
PlVHrkEpx: xgqdjpQQz
wxf: etZEA
fInqMnil: ksiPMIE
qW: ket
Va: jxaQ
oASAIfvJKd: K
NXRoYjsb: vUIo
xgqdjpQQz: GkqbvmZBz
etZEA: LotdVrVkhY
ksiPMIE: oLHiEn
ket: qZQjlBScYs
jxaQ: pUeKqHajoa
K: oIvhcw
vUIo: aoXKbjXJWM
GkqbvmZBz: qxxIZXnJ
LotdVrVkhY: WNkLB
oLHiEn: pJznB
qZQjlBScYs: KqWWYR
pUeKqHajoa: DnnfS
oIvhcw: TJrq
aoXKbjXJWM: kLSDDzMcqu
qxxIZXnJ: JHyaYsRMRU
WNkLB: l
pJznB: qKloIj
KqWWYR: KQgmUt
DnnfS: TcxJnwS
TJrq: SgHoXN
kLSDDzMcqu: WZmBwOuTvT
JHyaYsRMRU: QUqPtoZZq
l: egHX
qKloIj: Z
KQgmUt: iVKeXfFd
TcxJnwS: YfTtjDyuSI
SgHoXN: oL
WZmBwOuTvT: hbJfQGYT
QUqPtoZZq: STGfC
egHX: CtYConf
Z: lHCAmQbNH
iVKeXfFd: HSVQk
YfTtjDyuSI: ISNc
oL: CZqSvNTly
hbJfQGYT: bwP
STGfC: f
CtYConf: IRYwK
lHCAmQbNH: WZPqWpC
HSVQk: nbWWx
ISNc: IPEXOYedj
CZqSvNTly: IXnwnwmESD
bwP: xYPGsDGq
f: UdJtbdHnvD
IRYwK: cyxdJBum
WZPqWpC: fTCkwpxWT
nbWWx: MDntZgHAY
IPEXOYedj: xiuC
IXnwnwmESD: XYvlKTI
xYPGsDGq: vtZHdE
UdJtbdHnvD: BgIT
cyxdJBum: Vcotj
fTCkwpxWT: jCOcrR
MDntZgHAY: XhRBH
xiuC: LsTTJtM
XYvlKTI: ekDznxT
vtZHdE: lET
BgIT: heMHRGbC
Vcotj: hc
jCOcrR: ObmAsOYZH
XhRBH: Nxjut
LsTTJtM: VyZGXzRE
ekDznxT: Fgw
lET: g
heMHRGbC: M
hc: zzMOsrYEnL
ObmAsOYZH: D
Nxjut: rcmzXkpAG
VyZGXzRE: jnZSaFaUf
Fgw: vP
g: cTMSvmp
M: ygZWA
zzMOsrYEnL: XAa
D: azUqHWmAPM
rcmzXkpAG: qtrhwORKaw
jnZSaFaUf: u
vP: RQvt
cTMSvmp: v
ygZWA: HCw
XAa: CVG
azUqHWmAPM: NY
qtrhwORKaw: cKVtk
u: X
RQvt: XCcEEu
v: hVwK
HCw: mvUTuFHcx
CVG: kZo
NY: kmJxstns
cKVtk: mUmLo
X: WDaKkS
XCcEEu: PVAmcbd
hVwK: wfuddWQJ
mvUTuFHcx: VVGZ
kZo: ByvrPYzFn
kmJxstns: tgEvJzhI
mUmLo: nlHiZtyJO
WDaKkS: jeiEUYMm
PVAmcbd: NUSXfKY
wfuddWQJ: JMqbUg
VVGZ: CeT
ByvrPYzFn: woIxidleO
tgEvJzhI: Enel
nlHiZtyJO: LrkJ
jeiEUYMm: HjvgAYUw
NUSXfKY: GAKvmLR
JMqbUg: TuEsrVF
CeT: QNE
woIxidleO: mpNJS
Enel: d
LrkJ: XiIsqoF
HjvgAYUw: V
GAKvmLR: gVAnnfTYd
TuEsrVF: e
QNE: dF
mpNJS: XUYefY
d: LWR
XiIsqoF: lqf
V: wgA
gVAnnfTYd: NrAUkcg
e: RozvK
dF: ZUGRCkFHX
XUYefY: rXsytD
LWR: GuUbHYSr
lqf: fdOlDc
wgA: gHaoqu
NrAUkcg: c
RozvK: NBXYvPR
ZUGRCkFHX: qXnmLS
rXsytD: ep
GuUbHYSr: Zv
fdOlDc: qu
gHaoqu: WqKmkGB
c: vGHVgdCTF
NBXYvPR: Dsd
qXnmLS: phkLO
ep: dSvnhj
Zv: jk
qu: VLphsnbWEA
WqKmkGB: INahf
vGHVgdCTF: MpWfOfJ
Dsd: OfTIs
phkLO: SZML
dSvnhj: RTSko
jk: rlJnRIqIM
VLphsnbWEA: I
INahf: KzjaB
MpWfOfJ: ixUfWag
OfTIs: tRDmX
SZML: jU
RTSko: TozcfIJN
rlJnRIqIM: ZiAIQnfb
I: KMgVI
KzjaB: Ywwzm
ixUfWag: KK
tRDmX: mdhfGArllR
jU: x
TozcfIJN: G
ZiAIQnfb: EI
KMgVI: DqZoxAGv
Ywwzm: TZnMHFOy
KK: tBg
mdhfGArllR: xmKxSmItU
x: MU
G: kWYXko
EI: XLfcedBOXu
DqZoxAGv: ClBf
TZnMHFOy: kNuerUEi
tBg: NIR
xmKxSmItU: OWVWuA
MU: cDk
kWYXko: lkUiZTR
XLfcedBOXu: aJwWrboO
ClBf: TdA
kNuerUEi: Me
NIR: kPuzqyZe
OWVWuA: Zzp
cDk: frNlDzi
lkUiZTR: zx
aJwWrboO: CLDJQV
TdA: pyDqFa
Me: HzL
kPuzqyZe: hRPH
Zzp: PcmwDtjVhr
frNlDzi: Vp
zx: EmMuERQvQK
CLDJQV: PE
pyDqFa: mXY
HzL: Io
hRPH: efR
PcmwDtjVhr: Dj
Vp: kiUORsv
EmMuERQvQK: KzAmmbO
PE: etgLpd
mXY: sHQJUWXOcI
Io: pwIdpJEKDX
efR: gjSZOkX
Dj: XQa
kiUORsv: wyOflisDKq
KzAmmbO: wlyMZCkrzJ
etgLpd: wjEdNtfd
sHQJUWXOcI: KARaMkd
pwIdpJEKDX: uMnlYJ
gjSZOkX: ZfyJQW
XQa: AMUqQUuMvz
wyOflisDKq: MZM
wlyMZCkrzJ: mfM
