ENCODE
nFll: SABe AaXl qMOFnak ZPi gYqGlleT dIM eC qpu FMWHqv RheToERmPq HRNsnlBhrs gVIdxkBCRn JxUwPSmPY MAr
AaXl: sVfAYcfXbh
gYqGlleT: Hx
dIM: ICGrhu
eC: W
qpu: ghinv
FMWHqv: JSsAl
RheToERmPq: XeekyPyXuD
gVIdxkBCRn: wOMHA
JxUwPSmPY: pnY
MAr: om
SABe: Uqr
qMOFnak: LBjk
ZPi: dno
HRNsnlBhrs: PmkeoXymJ
sVfAYcfXbh: XoicyI
Hx: DZznB
ICGrhu: lnT
W: kEw
ghinv: KlWXmYl
JSsAl: Qscad
XeekyPyXuD: GGs
wOMHA: xZGQzwE
pnY: EkiaVbNkM
om: mh
Uqr: chXY
LBjk: L
dno: ZWls
PmkeoXymJ: faIcYc
XoicyI: AbkPbaXR
DZznB: JHOOsj
lnT: OvPNbOgTwq
kEw: xhNCF
KlWXmYl: XlLuEz
Qscad: hJHgNSiP
GGs: mbTScFJOS
xZGQzwE: fYfGVw
EkiaVbNkM: OAzGs
mh: WLYCMHRGw
chXY: XVZdzz
L: ymxc
ZWls: kERQj
faIcYc: rOQgsI
AbkPbaXR: jLnpBFQ
JHOOsj: q
OvPNbOgTwq: DJ
xhNCF: wme
XlLuEz: xhYys
hJHgNSiP: oNPJ
mbTScFJOS: iC
fYfGVw: Efx
OAzGs: KTqn
WLYCMHRGw: jPF
XVZdzz: XIU
ymxc: Vdrk
kERQj: JmN
rOQgsI: NRUFiLoY
jLnpBFQ: HA
q: SdZpMmljiq
DJ: WgUlWJk
wme: QLwRcZk
xhYys: IpZ
oNPJ: JiMlUGK
iC: fBKFZgQln
Efx: sTAybx
KTqn: NnDRJLWiQE
jPF: s
XIU: E
Vdrk: FOkpuUJYJ
JmN: qRWPl
NRUFiLoY: PThuZCys
HA: XOu
SdZpMmljiq: aWnKvqy
WgUlWJk: LnslbhNL
QLwRcZk: XictnjaZR
IpZ: UmMX
JiMlUGK: nVo
fBKFZgQln: qOp
sTAybx: mDuwJ
NnDRJLWiQE: bWEpgQyeMQ
s: Kl
E: hDWNOBND
FOkpuUJYJ: yAeWT
qRWPl: yBo
PThuZCys: ZCLHI
XOu: roCDfn
aWnKvqy: TYc
LnslbhNL: ljapfx
XictnjaZR: roIevwDB
UmMX: MElHQiiCD
nVo: BAEwbbRy
qOp: KFSsjLKw
mDuwJ: NmahPO
bWEpgQyeMQ: ewB
Kl: CPmzgxuS
hDWNOBND: y
yAeWT: PXFMAh
yBo: oLCtYqeMd
ZCLHI: HsLNgJ
roCDfn: uIt
TYc: sV
ljapfx: AROHQ
roIevwDB: GxrsNTyFV
MElHQiiCD: yew
BAEwbbRy: XAnTMjXIv
KFSsjLKw: qJH
NmahPO: VkNslfnzMy
ewB: YzLnKbS
CPmzgxuS: fowLyu
y: iKOiTGRnQ
PXFMAh: Feb
oLCtYqeMd: vL
HsLNgJ: qNDiX
uIt: YCmCAPCLEl
sV: nPhho
AROHQ: XkxEPc
GxrsNTyFV: HQyk
yew: xmjcV
XAnTMjXIv: BMKngGBAro
qJH: HZIbnNXG
VkNslfnzMy: oOhFxAiQ
YzLnKbS: Wsy
fowLyu: iAnQAxa
iKOiTGRnQ: IMTGo
Feb: iIXKQiM
vL: rcFmS
qNDiX: QhEPwb
YCmCAPCLEl: yqhCtBDb
nPhho: cvvwbHGor
XkxEPc: yb
HQyk: HF
xmjcV: jCiaaH
BMKngGBAro: WeVfIzegr
HZIbnNXG: hC
oOhFxAiQ: UISDp
Wsy: R
iAnQAxa: TqKpv
IMTGo: ulmC
iIXKQiM: vaXWEafk
rcFmS: Oc
QhEPwb: VQW
yqhCtBDb: bkvNd
cvvwbHGor: JkK
yb: EOND
HF: rNmFI
jCiaaH: pSw
WeVfIzegr: gZx
hC: HrhtNH
UISDp: IIr
R: tgAKp
TqKpv: P
ulmC: r
vaXWEafk: qasXM
Oc: LlGea
VQW: DueOXxYo
bkvNd: vDoocHWeE
JkK: bsaXGUwGwf
EOND: ooIZbygYgz
rNmFI: kZKNwHemOg
pSw: ENFOGKoMd
gZx: JhBVyfJF
HrhtNH: dLiCX
IIr: ptwhtzj
tgAKp: qSjQXiGMU
P: aRFqYETaJ
r: OUmnaPutjP
qasXM: ILAYDRqnN
LlGea: SCjpRXMiR
DueOXxYo: TRWlBCwT
vDoocHWeE: ClyTJaFh
bsaXGUwGwf: FPDLmAEUS
ooIZbygYgz: TnVtV
kZKNwHemOg: rrhOGYU
ENFOGKoMd: OWK
JhBVyfJF: dMl
dLiCX: iPwUYBc
ptwhtzj: fohNS
qSjQXiGMU: xqQApDbZtd
aRFqYETaJ: n
OUmnaPutjP: WNVLekB
ILAYDRqnN: TJRJasGSxK
SCjpRXMiR: VtAs
TRWlBCwT: sGEc
ClyTJaFh: cp
FPDLmAEUS: hZZHJie
TnVtV: BqwyvZqIQ
rrhOGYU: zKRhzJYZV
OWK: yZ
dMl: ju
iPwUYBc: Pet
fohNS: MDY
xqQApDbZtd: RpSAycKaB
n: mBEQod
WNVLekB: jJMFd
TJRJasGSxK: osAV
VtAs: wACcFEk
sGEc: yDI
cp: qUkKlJVKs
hZZHJie: FQttZT
BqwyvZqIQ: LPGlZm
zKRhzJYZV: FFIrAPY
yZ: wPkVdUQwhb
ju: bgO
Pet: Br
MDY: DrVbq
RpSAycKaB: FeuGi
mBEQod: ys
jJMFd: BWA
osAV: Bn
wACcFEk: Sb
yDI: qQTZrOe
qUkKlJVKs: pcScG
FQttZT: ingeCBjS
LPGlZm: ZxbbcsAoT
FFIrAPY: QozPJ
wPkVdUQwhb: uYqZ
bgO: bLJfbEYoQu
Br: Pi
DrVbq: IgNe
FeuGi: sOuE
ys: fIth
BWA: CxmsshbYNI
Bn: jDHQCnEIy
Sb: BRAHdl
qQTZrOe: N
pcScG: RN
ingeCBjS: eb
ZxbbcsAoT: bdXeTAIEQu
QozPJ: nldPqYFwi
uYqZ: IwPOENJO
bLJfbEYoQu: qtSdvECX
Pi: XOBNbw
IgNe: Plr
sOuE: T
fIth: VtXCxsOWVe
CxmsshbYNI: LYmeZtM
jDHQCnEIy: fXMyL
BRAHdl: MWj
N: GnQfhxtD
RN: QJnVI
eb: JRukx
bdXeTAIEQu: nn
nldPqYFwi: tBTXVGe
IwPOENJO: jhIxTgIFAp
qtSdvECX: swRer
XOBNbw: NbuEHZjXb
Plr: pf
T: KVycJoc
VtXCxsOWVe: hFaYfle
LYmeZtM: kwTRhIWkvF
fXMyL: XbGDlzq
MWj: mYg
GnQfhxtD: ZhTSnbGHxa
QJnVI: kMBt
JRukx: a
nn: pCCbnnngH
tBTXVGe: uLDB
jhIxTgIFAp: LVC
swRer: JcZZVxGsx
NbuEHZjXb: RHkoFSejJz
pf: ZKhnQtfcj
KVycJoc: KzVsHYB
hFaYfle: zF
kwTRhIWkvF: dmzWakyxi
XbGDlzq: S
mYg: SE
ZhTSnbGHxa: OYnUEZi
kMBt: dXHJ
a: JRJ
pCCbnnngH: lBCv
uLDB: iJp
LVC: dgKMHf
JcZZVxGsx: UMFbR
RHkoFSejJz: zBqW
ZKhnQtfcj: eLMK
KzVsHYB: HbioAjWwB
zF: mwYFyQQZ
dmzWakyxi: lSuSOZpd
S: XYNSQXLH
SE: MYsjX
OYnUEZi: cMZXGBbQd
dXHJ: uMiLuIuRX
JRJ: sD
lBCv: rnGxUG
iJp: KHb
dgKMHf: CKeKRo
UMFbR: MjIpf
zBqW: csnr
eLMK: jFbIfmMT
HbioAjWwB: jfG
mwYFyQQZ: PSro
lSuSOZpd: djCVnIya
XYNSQXLH: bnPE
MYsjX: kYqfIs
cMZXGBbQd: tKdLUNPvd
uMiLuIuRX: ywLxexi
sD: TtpTfHHJX
rnGxUG: UFMdYPZg
KHb: gODCby
CKeKRo: k
MjIpf: tjaaYZgT
csnr: IZ
jFbIfmMT: p
jfG: aaPeHz
PSro: PSj
djCVnIya: dccFBoii
bnPE: Elq
kYqfIs: wFZwYdS
tKdLUNPvd: hJPRm
ywLxexi: LLZvO
TtpTfHHJX: VWDhN
UFMdYPZg: IqFmit
gODCby: Cdg
k: xQkHe
tjaaYZgT: jspTiu
IZ: yImfdI
p: TPzw
aaPeHz: z
PSj: qiLry
dccFBoii: UsMnetLQ
Elq: BcywFRg
wFZwYdS: ZU
hJPRm: XpbqPd
LLZvO: la
VWDhN: YWUUHHbfdl
IqFmit: J
Cdg: uzRZL
xQkHe: muKK
jspTiu: SNqgTQSNlC
yImfdI: EBXJMZYPgT
TPzw: DwHiCKl
z: zSWvg
qiLry: dLzCk
UsMnetLQ: Ttx
BcywFRg: QblqWK
ZU: NxTiwVx
XpbqPd: SXDAe
la: RBYIn
YWUUHHbfdl: rtyQz
J: JheipRfZbi
uzRZL: tXOkZjnf
muKK: CGr
SNqgTQSNlC: PkTLcq
EBXJMZYPgT: wRIOWRNSdK
DwHiCKl: jKF
zSWvg: qqJYgKqz
dLzCk: o
Ttx: AwGwSyxb
QblqWK: YVivdBiv
NxTiwVx: iVqTM
SXDAe: rrMmzUuS
RBYIn: OnE
rtyQz: hYryGP
JheipRfZbi: UqmuQ
tXOkZjnf: eUdNZtAS
CGr: dKBv
PkTLcq: IkKWKN
wRIOWRNSdK: Oal
jKF: fHRxffDw
qqJYgKqz: tE
o: LrvG
AwGwSyxb: rPBD
YVivdBiv: xnpJbVDk
iVqTM: bcsNm
rrMmzUuS: JxIbbmrJr
OnE: w
hYryGP: lMwawYZO
UqmuQ: Y
eUdNZtAS: aSUkpBvNqC
dKBv: tnEmFWFE
IkKWKN: DlZwbt
Oal: tFWg
fHRxffDw: knVOkWYiV
tE: IlNtMkLiO
LrvG: F
rPBD: SVuqJBTyTO
xnpJbVDk: uS
bcsNm: UcxYaCd
JxIbbmrJr: oRbdhqu
w: wLPMrHwMVI
lMwawYZO: qcB
Y: bZD
aSUkpBvNqC: bZRitVyw
tnEmFWFE: dHqa
DlZwbt: RQUPC
tFWg: rgTs
knVOkWYiV: wWLnFHfAk
IlNtMkLiO: XOygGB
F: Mo
SVuqJBTyTO: XMiNM
uS: ERFUEdo
UcxYaCd: nannQkmpk
oRbdhqu: rSwLvZ
wLPMrHwMVI: ewST
qcB: WQjJDLZY
bZD: MmkmxhDj
bZRitVyw: lTmyYvSHA
dHqa: qpEa
RQUPC: njPJgEbWTa
rgTs: csjTMxxot
wWLnFHfAk: LXG
XOygGB: TSQpigSrG
Mo: CsG
XMiNM: KB
ERFUEdo: XuejRBWabG
nannQkmpk: EkITaInWd
rSwLvZ: td
ewST: b
WQjJDLZY: fEZ
MmkmxhDj: fuxyudJ
lTmyYvSHA: ZiNgxsVqai
qpEa: jtuydXO
njPJgEbWTa: bORAe
csjTMxxot: Jus
LXG: JvxssLXZRK
TSQpigSrG: zHvGRTxF
CsG: kRb
KB: ohSp
XuejRBWabG: oNkEZNp
EkITaInWd: UPVeiQLpol
td: Yv
b: wL
fEZ: KlvgWBvx
fuxyudJ: cuNzssG
ZiNgxsVqai: OedGH
jtuydXO: ESaMiGjVAz
bORAe: nVaw
Jus: tpYkeBi
JvxssLXZRK: CBUxa
zHvGRTxF: NOXyK
kRb: zNpOltQjJR
ohSp: lR
oNkEZNp: tOC
UPVeiQLpol: wbPdaQL
Yv: jgJlDV
wL: huGF
KlvgWBvx: OzRETpjxV
cuNzssG: Z
OedGH: XsXy
ESaMiGjVAz: xReupG
nVaw: BdFlX
tpYkeBi: zkVT
CBUxa: f
NOXyK: YkGJQTA
zNpOltQjJR: fdUgBlpJ
lR: Lqa
tOC: NDezUToP
wbPdaQL: ogKWZqsp
jgJlDV: XoETVmKTyV
huGF: Bixr
OzRETpjxV: tWnPp
Z: sRse
XsXy: nHzEKrAcFo
xReupG: exkGj
BdFlX: WlFZq
zkVT: VyvswVkzu
f: HurKLj
YkGJQTA: Kmaf
fdUgBlpJ: nnrIBs
Lqa: ssQUUK
NDezUToP: XsNf
ogKWZqsp: bhXcXT
XoETVmKTyV: zmEgLmVMou
Bixr: leDIrHk
tWnPp: cU
sRse: g
nHzEKrAcFo: syJu
exkGj: M
WlFZq: umBFB
VyvswVkzu: rQFXUx
HurKLj: dZroMwFyka
Kmaf: D
nnrIBs: jlxN
ssQUUK: KaCnZ
XsNf: iIkXh
bhXcXT: jTiirb
zmEgLmVMou: iiodU
leDIrHk: mlakvFE
cU: vP
g: mW
syJu: jkStREbzu
M: lKJjxlrW
umBFB: cf
rQFXUx: NK
dZroMwFyka: sPzJg
D: aqmolF
jlxN: u
KaCnZ: v
iIkXh: EAuXkfIR
jTiirb: SBzkwnzK
iiodU: HLWXXj
mlakvFE: DHAYErDdW
vP: sanowV
mW: phYbcKrK
jkStREbzu: BKA
lKJjxlrW: tLZrGeQEpX
cf: FffmOQVFdX
NK: PSNSoN
sPzJg: MuOcwo
aqmolF: yzqsidcQf
u: ctGFRP
v: HtXxWhaeoh
EAuXkfIR: XlobWqE
SBzkwnzK: SEXBPrWEw
HLWXXj: VJvCAgEW
DHAYErDdW: kQvE
sanowV: fEdSkj
phYbcKrK: JnF
BKA: oG
tLZrGeQEpX: zzRye
FffmOQVFdX: tNiG
PSNSoN: HNB
MuOcwo: quABNdBjO
yzqsidcQf: TvDy
ctGFRP: rsErhgzTYW
HtXxWhaeoh: gd
XlobWqE: V
SEXBPrWEw: XLpT
VJvCAgEW: ATfeSPNK
kQvE: oXj
fEdSkj: ExgL
JnF: NfpOnZJX
oG: KdPZRLbWqa
zzRye: xVQe
tNiG: yC
HNB: gY
quABNdBjO: kfZdT
TvDy: yqDQdRR
rsErhgzTYW: nnbJmxI
gd: pMoD
V: dPSXizfP
XLpT: vaEllM
ATfeSPNK: ZFcx
oXj: HogiV
ExgL: WqPGmcmiJ
NfpOnZJX: Qqz
KdPZRLbWqa: uiryG
xVQe: akEqFCWF
yC: MJHDDR
gY: yWCW
kfZdT: awFwJVf
yqDQdRR: hzPQRJqF
nnbJmxI: PnYqtqF
pMoD: wrPrpGRWw
dPSXizfP: UGCwqFDX
vaEllM: IYVr
ZFcx: hAxmxrKMq
HogiV: LPQIYcJtMx
WqPGmcmiJ: IQDQvNtIG
Qqz: LgPiv
uiryG: iohBvYGQX
akEqFCWF: wfq
MJHDDR: slEFpLOr
yWCW: LWBn
awFwJVf: bktsUw
hzPQRJqF: DgiX
PnYqtqF: FNmNw
wrPrpGRWw: MPxWGAiCh
UGCwqFDX: JCJqar
IYVr: bXU
hAxmxrKMq: PYeHq
LPQIYcJtMx: IdnaRGAOpS
IQDQvNtIG: ftzFzWPZ
LgPiv: gcXyTUpIAQ
iohBvYGQX: KRBLMrmmNR
wfq: HyZkdQFcN
slEFpLOr: GfFqCab
LWBn: KTxBRrcjk
bktsUw: JBpXgfO
DgiX: QC
FNmNw: ETLM
MPxWGAiCh: wiSQOB
JCJqar: NBi
bXU: lSIr
PYeHq: zFMMOWVLj
IdnaRGAOpS: FSVAOYzboB
ftzFzWPZ: ivKQ
gcXyTUpIAQ: GqRkBp
KRBLMrmmNR: lfhlXKK
HyZkdQFcN: TDxoRtSb
GfFqCab: KuThxsn
KTxBRrcjk: kMAacopaQ
JBpXgfO: NNxrCzW
QC: fg
ETLM: cNrGIWhNuJ
wiSQOB: RAvE
