ENCODE
ALhbVMOrn: VcaYHbwI nO BUgByyCU dh GU YCX A PUYfhsUe hrjFVGlCDV
VcaYHbwI: ZMhInbwSEo
BUgByyCU: W
dh: DiE
GU: McENoqNTKk
YCX: xJeuP
nO: FUPVl
A: OU
PUYfhsUe: MzHiih
hrjFVGlCDV: tWQG
ZMhInbwSEo: PSp
W: rjDPydlwDC
DiE: VOjNxFEgj
McENoqNTKk: YLZaMuN
xJeuP: GnAdWokjh
FUPVl: cV
OU: aoHKk
MzHiih: LHscMS
tWQG: oqGpj
PSp: L
rjDPydlwDC: GEuIYbzwa
VOjNxFEgj: wbp
YLZaMuN: tZlFyKcR
GnAdWokjh: XvxLXd
cV: hWloxL
aoHKk: yTs
LHscMS: jxDrlOCIaU
oqGpj: GOZ
L: j
GEuIYbzwa: AstA
wbp: nLHBmdOGAm
tZlFyKcR: fSaBm
XvxLXd: lOhVhSBvAg
hWloxL: q
yTs: uiDkICvOwq
jxDrlOCIaU: jaUDXVt
GOZ: OYjWoYpZ
j: rWXz
AstA: vLKEu
nLHBmdOGAm: RjybxWFMdH
fSaBm: MXeWoqJr
lOhVhSBvAg: cE
q: QxkLV
uiDkICvOwq: CaTMfQ
jaUDXVt: CMoH
OYjWoYpZ: qZ
rWXz: s
vLKEu: voV
RjybxWFMdH: LLnNePuprf
MXeWoqJr: ooCUq
cE: YSwNK
QxkLV: E
CaTMfQ: EdaeAxK
CMoH: IUVgDM
qZ: iSeumg
s: nbLUu
voV: vRNshm
LLnNePuprf: LtWYZGIRN
ooCUq: YWwsbI
YSwNK: qpNdscW
E: vbKynYXupl
EdaeAxK: zOqpiG
IUVgDM: OwAvEMIUE
iSeumg: pziAOCR
nbLUu: ViGwiezgVg
vRNshm: IGsPW
LtWYZGIRN: zMBg
YWwsbI: AUtcgNJrhJ
qpNdscW: Hkv
vbKynYXupl: CPvDK
zOqpiG: PFmOjMhDPT
OwAvEMIUE: Hisst
pziAOCR: RE
ViGwiezgVg: xrCACpVr
IGsPW: bRKK
zMBg: iuxGE
AUtcgNJrhJ: CmnaCuVA
Hkv: tBeibTDt
CPvDK: y
PFmOjMhDPT: aUQlxSWE
Hisst: RdDGYaug
RE: RQjYQEHOAH
xrCACpVr: SKGjc
bRKK: BkToUSUQ
iuxGE: paahniYlov
CmnaCuVA: oFdNJtAJH
tBeibTDt: BgSFddKLr
y: myE
aUQlxSWE: SQwxby
RdDGYaug: Sm
RQjYQEHOAH: flmgzsSu
SKGjc: QkC
BkToUSUQ: VRwfPBgI
paahniYlov: CUD
oFdNJtAJH: zhotqxNuX
BgSFddKLr: FSQch
myE: mY
SQwxby: vA
Sm: sZ
flmgzsSu: EdmFhUVJAy
QkC: xmximCvCMz
VRwfPBgI: OnjcaTPexe
CUD: WkKrWsfl
zhotqxNuX: wBGzGaR
FSQch: dGqO
mY: Dk
vA: xUmr
sZ: yCacJvo
EdmFhUVJAy: eJYI
xmximCvCMz: CFQGTdhcRx
OnjcaTPexe: QlKTlqG
WkKrWsfl: RT
wBGzGaR: cb
dGqO: IOATZ
Dk: vV
xUmr: R
yCacJvo: Gs
eJYI: pYDYivQEvj
CFQGTdhcRx: oYq
QlKTlqG: tQbJmYwJ
RT: QDiEUgra
cb: NrkaYbYTMJ
IOATZ: ArPLHwchzF
vV: zHN
R: h
Gs: lRFhZeUsTn
pYDYivQEvj: RTTzDWUYX
oYq: kUuhV
tQbJmYwJ: SyinSGoJC
QDiEUgra: wNNRa
NrkaYbYTMJ: C
ArPLHwchzF: XPJGzeR
zHN: xBRIes
h: r
lRFhZeUsTn: XgZnMjXoCu
RTTzDWUYX: GNBkPgFLox
kUuhV: IK
SyinSGoJC: vE
wNNRa: WCZ
C: VoR
XPJGzeR: IYJ
xBRIes: ALjnsmf
r: UibmkAtLUv
XgZnMjXoCu: sOK
GNBkPgFLox: FwqVjfoHIB
IK: WaiYkvEeD
vE: mFispiDxz
WCZ: fnG
VoR: BuOMdfnFk
IYJ: dtUpxAm
ALjnsmf: IGElH
UibmkAtLUv: vVDrew
sOK: BawXYOE
FwqVjfoHIB: EM
WaiYkvEeD: nE
mFispiDxz: PdgvGAe
fnG: FJC
BuOMdfnFk: fAGXPpZzf
dtUpxAm: LXcjQilgH
IGElH: PjukVE
vVDrew: iyJczewlzW
BawXYOE: xEzKoSdhw
EM: Vzi
nE: n
PdgvGAe: wauzJH
FJC: hldwl
fAGXPpZzf: aLx
LXcjQilgH: wQAFf
PjukVE: EcWEqwlBb
iyJczewlzW: OpbeJS
xEzKoSdhw: UJ
Vzi: ju
n: yyvVnjQLr
wauzJH: pxnhl
hldwl: Dayb
aLx: RaiXDhf
wQAFf: tc
EcWEqwlBb: nJxC
OpbeJS: jSPEiWnQ
UJ: IDlg
ju: QxfokoSu
yyvVnjQLr: i
pxnhl: nLy
Dayb: zaVLdpIv
RaiXDhf: xdAGn
tc: KZhbZ
nJxC: U
jSPEiWnQ: JI
IDlg: QHFGbRVeL
QxfokoSu: hGoVv
i: DI
nLy: Bekq
zaVLdpIv: AYjEQQH
xdAGn: MkYF
KZhbZ: qCH
U: ntrbg
JI: sompqgZU
QHFGbRVeL: tn
hGoVv: BoLqKRI
DI: OVSgRwb
Bekq: Nv
AYjEQQH: nD
MkYF: PcZjMvWPtx
qCH: blCzsDm
ntrbg: HfNR
sompqgZU: MwSQmR
tn: jqmDavSM
BoLqKRI: emweDIt
OVSgRwb: vwWN
Nv: KPNXflQvdP
nD: T
PcZjMvWPtx: qBpyLhBOov
blCzsDm: Sw
HfNR: IIdSp
MwSQmR: PIA
jqmDavSM: UmEDhyFe
emweDIt: pnBRDCwG
vwWN: hszeDgl
KPNXflQvdP: ywTUX
T: uQxCZk
qBpyLhBOov: riFiHYwg
Sw: hPZRTwCgZm
IIdSp: B
PIA: DFESFlrc
UmEDhyFe: fLLhELV
pnBRDCwG: Ag
hszeDgl: hXxrJT
ywTUX: a
uQxCZk: Dhmy
riFiHYwg: wIAtPbLnlM
hPZRTwCgZm: yCGQuyd
B: pFoSbw
DFESFlrc: OLQFx
fLLhELV: NpAhAuxN
Ag: mjEszTKdR
hXxrJT: TXLzFDMmvk
a: hCgpgqPhQ
Dhmy: SHeeTGTcjQ
wIAtPbLnlM: S
yCGQuyd: riiugsbrx
pFoSbw: oggpWsHJO
OLQFx: PalMXWuTM
NpAhAuxN: OsTzXWh
mjEszTKdR: KvdGfrjKF
TXLzFDMmvk: OEXSjl
hCgpgqPhQ: GSigzwyx
SHeeTGTcjQ: ggl
S: iYTTRyA
riiugsbrx: dkPtpdgR
oggpWsHJO: ljZUAOMAwV
PalMXWuTM: HQFnRtXx
OsTzXWh: KdafCad
KvdGfrjKF: JduX
OEXSjl: JWzJxUnoQk
GSigzwyx: xe
ggl: ocTvySvNo
iYTTRyA: Bnyn
dkPtpdgR: iPMHQP
ljZUAOMAwV: wrDfg
HQFnRtXx: AsFHs
KdafCad: DAA
JduX: GB
JWzJxUnoQk: kz
xe: OC
ocTvySvNo: Jzcjpc
Bnyn: gHP
iPMHQP: zBg
wrDfg: RdKXzUdToe
AsFHs: LXuFyJU
DAA: XGaYDgskG
GB: SzhQcCiCz
kz: wzccbmQwcj
OC: qqrvnbY
Jzcjpc: Ry
gHP: CsOIzJ
zBg: XuyRZz
RdKXzUdToe: vZRKXdcT
LXuFyJU: jhrMpCR
XGaYDgskG: nYXjYdPefU
SzhQcCiCz: KDDs
wzccbmQwcj: ZkCtcXe
qqrvnbY: LkVw
Ry: JGRyRxBt
CsOIzJ: kmXlXUPBe
XuyRZz: pmOm
vZRKXdcT: JnLWbq
jhrMpCR: IioswLV
nYXjYdPefU: avV
KDDs: p
ZkCtcXe: ejVDickV
LkVw: laOVa
JGRyRxBt: CMNbkvwN
kmXlXUPBe: bx
pmOm: vIf
JnLWbq: XWu
IioswLV: sBRYiybUz
avV: BCtVGSbHil
p: DUucxiCuf
ejVDickV: pzjZeir
laOVa: njfLMs
CMNbkvwN: dlCbsTpDnM
bx: Q
vIf: MVHFvu
XWu: Dv
sBRYiybUz: UXzXeo
BCtVGSbHil: FPYeZCLg
DUucxiCuf: ROblCj
pzjZeir: XrVDlN
njfLMs: hoKRrftHJ
dlCbsTpDnM: EBK
Q: wKFlhH
MVHFvu: fyrScc
Dv: GAIeeXo
UXzXeo: McEyZWKhId
FPYeZCLg: wPsegRcpi
ROblCj: RbcdA
XrVDlN: WKXZVX
hoKRrftHJ: toeYqTdG
EBK: oK
wKFlhH: NohmVJai
fyrScc: uNAhauKyA
GAIeeXo: CKvUUdMrT
McEyZWKhId: rqljcBO
wPsegRcpi: kQ
RbcdA: LnaMRMIT
WKXZVX: oKhWl
toeYqTdG: wMjWnkm
oK: XQLDRwCH
NohmVJai: GIHcXxAUU
uNAhauKyA: dbnGBhaZjL
CKvUUdMrT: RJjILYnVjm
rqljcBO: jTIvUcvL
kQ: CBDqRnjt
LnaMRMIT: MhSYcsqf
oKhWl: UVEVFpqpIC
wMjWnkm: DnwpsBsOXL
XQLDRwCH: xfPAG
GIHcXxAUU: w
dbnGBhaZjL: Y
RJjILYnVjm: GrtBARq
jTIvUcvL: xo
CBDqRnjt: HdKRQWEyTi
MhSYcsqf: dDR
UVEVFpqpIC: LflYSISBi
DnwpsBsOXL: RLFYppby
xfPAG: aJzgdKcTpu
w: Cz
Y: ly
GrtBARq: ZcCfZeraex
xo: vm
HdKRQWEyTi: XAJeaV
dDR: bBacPMR
LflYSISBi: YRd
RLFYppby: PJHzNY
aJzgdKcTpu: F
Cz: sGLDLt
ly: MlUhePP
ZcCfZeraex: NxIx
vm: Qv
XAJeaV: UjhA
bBacPMR: NaTSPd
YRd: UZSKjS
PJHzNY: gyZPopKy
F: UsNBARGl
sGLDLt: cUNq
MlUhePP: RraKf
NxIx: qS
Qv: O
UjhA: yX
NaTSPd: QWvMXIHWv
UZSKjS: vTTH
gyZPopKy: LldskHtzq
UsNBARGl: toOvCuM
cUNq: cCwTOzhiUi
RraKf: gXJTPji
qS: QyzJSZJtoo
O: OGBBMLGFZc
yX: ie
QWvMXIHWv: VpbpzpXnXv
vTTH: wIdxInzU
LldskHtzq: SGXNjRdqPD
toOvCuM: bGDdWGSROd
cCwTOzhiUi: yFLXV
gXJTPji: qDtDKRA
QyzJSZJtoo: OMYUK
OGBBMLGFZc: PGjjTRlNF
ie: wDk
VpbpzpXnXv: zXj
wIdxInzU: UBfDeCBVr
SGXNjRdqPD: qwy
bGDdWGSROd: pGd
yFLXV: b
qDtDKRA: IoNiAVKNZ
OMYUK: EVe
PGjjTRlNF: fxtGfHaTQ
wDk: DEEwxtFG
zXj: fwRfomJr
UBfDeCBVr: jaY
qwy: pEAuzaj
pGd: bmYnhH
b: Sd
IoNiAVKNZ: ZItp
EVe: K
fxtGfHaTQ: gStBhIeds
DEEwxtFG: iFIrjUX
fwRfomJr: Yv
jaY: rpTxJwTKyk
pEAuzaj: zoBqq
bmYnhH: wEetoM
Sd: bpcca
ZItp: zNKLbRn
K: ykRSRAxcg
gStBhIeds: eJJibmuqH
iFIrjUX: XkgXi
Yv: Da
rpTxJwTKyk: vnTxlgqxu
zoBqq: LexctTvrxG
wEetoM: l
bpcca: epvJej
zNKLbRn: hdaxo
ykRSRAxcg: BioC
eJJibmuqH: SSjG
XkgXi: oQTfHAj
Da: rYgJbIYiLf
vnTxlgqxu: KEJAYYYgLY
LexctTvrxG: ifKNtJ
l: FxhcrRB
epvJej: FRL
hdaxo: LmZhEjNST
BioC: lt
SSjG: VzpjaTJCJC
oQTfHAj: ETFXxQEA
rYgJbIYiLf: zUpV
KEJAYYYgLY: Z
ifKNtJ: REOF
FxhcrRB: pu
FRL: ixBGFUGh
LmZhEjNST: jNjPtC
lt: VLMqGkZfb
VzpjaTJCJC: jexEU
ETFXxQEA: BTdhHDklu
zUpV: f
Z: WEkpJGtHzT
REOF: DazWn
pu: DOEkZugffc
ixBGFUGh: WVOq
jNjPtC: KnyHzbD
VLMqGkZfb: geJ
jexEU: IetgxVsP
BTdhHDklu: fQcP
f: eKWxbRNfg
WEkpJGtHzT: vYntTSIb
DazWn: icyaTAWDWQ
DOEkZugffc: aUExxq
WVOq: YiD
KnyHzbD: huCIWsf
geJ: JtJHUPqDJE
IetgxVsP: XmxHWS
fQcP: g
eKWxbRNfg: M
vYntTSIb: YeSZdxClr
icyaTAWDWQ: xSnxsUmSqR
aUExxq: FfJmfD
YiD: mV
huCIWsf: D
JtJHUPqDJE: epmSYVmtc
XmxHWS: TdwLWL
g: zmTtVduX
M: Vsqi
YeSZdxClr: TEuw
xSnxsUmSqR: cpmJB
FfJmfD: dSKZGkHWnc
mV: yh
D: JrTFGY
epmSYVmtc: pbJmLj
TdwLWL: UYcePzuCP
zmTtVduX: PS
Vsqi: jXY
TEuw: hAP
cpmJB: Xik
dSKZGkHWnc: pCLKiloYLH
yh: pNmTo
JrTFGY: u
pbJmLj: FnHHvlvpf
UYcePzuCP: yXsMShWg
PS: jNiPXjcz
jXY: OxDpGJ
hAP: hmnjA
Xik: X
pCLKiloYLH: luSMc
pNmTo: QTXbFDkgg
u: NeugxQfsFS
FnHHvlvpf: ooj
yXsMShWg: KHpEdJHn
jNiPXjcz: NB
OxDpGJ: yYsbDFous
hmnjA: xBG
X: cLvVXrq
luSMc: oG
QTXbFDkgg: TrRv
NeugxQfsFS: d
ooj: LWwvlX
KHpEdJHn: mQ
NB: V
yYsbDFous: e
xBG: vrh
cLvVXrq: qhQzghkf
oG: VCfTXMrj
TrRv: EakLgaev
d: FNXxZVCEUA
LWwvlX: xAvniZ
mQ: vfE
V: QCC
e: iP
vrh: jmmz
qhQzghkf: Fs
VCfTXMrj: KERvwAwOKP
EakLgaev: CEAnCyJBeM
FNXxZVCEUA: BpX
xAvniZ: wmzZl
vfE: c
QCC: uTkSfmHEtb
iP: vgjn
jmmz: fmOzkcC
Fs: YgUtp
KERvwAwOKP: dtrEVZyonx
CEAnCyJBeM: IYJM
BpX: DwX
wmzZl: DlBiE
c: I
uTkSfmHEtb: YdaX
vgjn: uP
fmOzkcC: VJIClDdJ
YgUtp: xhGGrHN
dtrEVZyonx: wNaWlbp
IYJM: DeYiI
DwX: xuyBOFGaZt
DlBiE: gMggpUJzq
I: IZxHymnaN
YdaX: OzSNVeI
uP: jGnAc
VJIClDdJ: WGSlFsZyeO
xhGGrHN: mfaRVc
wNaWlbp: hhUm
DeYiI: Ugp
xuyBOFGaZt: dvmh
gMggpUJzq: x
IZxHymnaN: G
OzSNVeI: lsGSod
jGnAc: okJtgp
WGSlFsZyeO: WxeHSYe
mfaRVc: xLAkNB
hhUm: gIzFHJpmf
Ugp: InqEulJx
dvmh: pdhAiqaMm
x: Pw
G: MyOEWCXfVQ
lsGSod: ILyPRYMHb
okJtgp: Snxwn
WxeHSYe: luDWLKpQFf
xLAkNB: MK
gIzFHJpmf: LOplIq
InqEulJx: gvhEWOHhZv
pdhAiqaMm: qodFa
Pw: nWl
MyOEWCXfVQ: fTFToAKim
ILyPRYMHb: dmgYJB
Snxwn: ZGSdaTz
luDWLKpQFf: Ow
MK: bACZRSK
LOplIq: dhTyN
gvhEWOHhZv: KLorUN
qodFa: hPphAzF
nWl: jgcGCgUt
fTFToAKim: guIWPKw
dmgYJB: Ii
ZGSdaTz: Yn
Ow: grrnrqU
bACZRSK: bAckheNYcw
dhTyN: MwhQHpS
KLorUN: Hj
hPphAzF: nxalgxQNCH
jgcGCgUt: wJEANw
guIWPKw: cq
Ii: Bni
Yn: ODcld
grrnrqU: vQwiSL
bAckheNYcw: zozK
MwhQHpS: ynkhBv
Hj: QvrhrlwCs
nxalgxQNCH: UxFsilmK
