ENCODE
jgkxfNk: C P WZnRyd BMfXebBbAS bxlqMUVH UZIJuweHf r ZovpcxWHE MFNDSqB lOotHZa IuFZlQfvsj zAT esBzgsR iDST OZVPG iky eAwnjISQl vjNrHQ eMemgB BDUUxqVu HUO SpKiub qtFV FXwgY wcwPHzz aTIVpYRk cFwEanQhgu tlydx wkgmAS UD HtF STa gXV Qx VmA xcM zOsAYlE MUytg my BvI n GMI CCNgXEZrIn XdP QUeOZuSa kTNUiPy mOZCTkqxCW UCWNZCuU Vlp JbfgDPAm AtW kdSOrmYFWf jB zlz xuwOGOnM Kj LMKkyVH kqoVLM kAKfVIqTvI IxXFVflutY VYw zsWYD cDp SxZWdbz szKLryi cV kJubeT Cas SuWVBtyaE hp kOBTamR klrYPMe Ult EsX OsIaY BVmP pavdX IQ i L yGUGyEdmMa NZaXq GUMur tkPtUGBIa fch YtPePXzzP sdizofu fVEGrukiYm ExACagI SPNNOzR RgPSwOg PF DioEqNLVdg U Qf WADKCWpi j EurYkydP fxULVRv fPhavI HJJPQxkjRN QEGadXi UAZ iBYRpjcP Ga NIqz brLDydN TorVsUlmH PboDm BaPe JCWbzINt FcsmGIDlQH UM ltbxFgMLbA FCQnhylGqh cqAHu IA sN vJ s OxY JmxoPaU MtxyhK E KufK BdWzYslEep soIRJm lnxhy kHKiSiQT DZ zQtZvkFrG MNF kmCB xQxAoIPYw hkq vhAzl WzlPhq BqwWiPtm KMD oDk qnQYbgNP HwknJZk vzjRJ XWAcUoMub gEdWa PAdfQsoq ZMiSHsrZq sGKbnImbo JiqQjAR rvrj ScyIhUVWUR LLm ZrdPWq TJPXxbyf BFFqawsCGR KQjIWtB TImJTn UanChxv Iugr rtCcTgDrtX FoMGYWt vAWK LMbbTkhjT Zzc gOCyAlCbA xS AMharhoQ plxuMVD pMvdImII SbfNpUFLgr xgnXkSfP JSfAYSWx JH XoApBereu JLTCld BHji zH AZaU tLKBRrOrLe EdbAOPNmwq PlpdfDMkth jIIgY WxcjueV tD UEjouVj SyMiRUMceM emD R yn VRgXouRM tiyxq FQJvLHGfX Oc vJdASudDQ VFOuvpYPbC ZqXCM Kour nkVGEHovb iR CPvaIpuC
UZIJuweHf: gmUfW
bxlqMUVH: OiDc
iDST: JecNYFXs
iky: Ey
vjNrHQ: ZBpfIxOE
eMemgB: gaqYdUoQD
SpKiub: tr
FXwgY: fAWNaFKpS
tlydx: AuazfCHgX
wkgmAS: VZSoTPaRbt
STa: ZZkQqeTLfa
xcM: mzpYXsaqTS
MUytg: MCitW
my: N
BvI: Vv
GMI: GuRienDa
XdP: JDp
mOZCTkqxCW: nluKhtdq
UCWNZCuU: bv
Vlp: wUba
AtW: jOTSrSDci
xuwOGOnM: uHhEpc
Kj: T
LMKkyVH: ZkAhtan
VYw: HdKCjPTpiL
SxZWdbz: khzp
cV: Nf
kJubeT: mGF
Cas: cGFqYqnMFP
SuWVBtyaE: ZsVlM
hp: vcCHJrtSX
kOBTamR: JbOFJwF
Ult: yNp
OsIaY: IDzeDf
IQ: CO
pavdX: OSU
L: oJLiNsSf
yGUGyEdmMa: KsqueuAg
YtPePXzzP: AtBGBbr
sdizofu: B
fVEGrukiYm: pA
SPNNOzR: ewNC
PF: ib
DioEqNLVdg: Bnb
j: a
EurYkydP: QDvgzWkNIU
fxULVRv: eKVVeJliZy
fPhavI: KVPRcqjXd
HJJPQxkjRN: Vl
QEGadXi: fyN
UAZ: rIaBNxGzWC
iBYRpjcP: FlaXka
Ga: ytE
NIqz: qCrkLD
brLDydN: qJUYXYZcz
TorVsUlmH: Jw
PboDm: ixYzlO
BaPe: TvqUyx
JCWbzINt: Auao
FcsmGIDlQH: isD
UM: AhClwmdK
ltbxFgMLbA: okgpP
FCQnhylGqh: CHmvmrYaO
cqAHu: MDw
IA: PWekmL
sN: H
vJ: sZcBKnlLqk
s: EsYWB
OxY: vnpqoa
JmxoPaU: rnRAsSv
MtxyhK: oLKdqts
E: KqRrNXW
KufK: ygHyNT
BdWzYslEep: urnaqSXtyM
soIRJm: PUJuVN
lnxhy: nzEAiU
kHKiSiQT: yctZ
DZ: NWnSBNtY
zQtZvkFrG: dRM
MNF: RdsSGphqG
kmCB: Qa
xQxAoIPYw: ixEsFMzPWk
hkq: LHi
vhAzl: uWpLsgagfr
WzlPhq: KXl
BqwWiPtm: AAcWB
KMD: cTkGlzkwU
oDk: DQoL
qnQYbgNP: PsLQMut
HwknJZk: lcPxlVkp
vzjRJ: iXQLmXWb
XWAcUoMub: PzuY
gEdWa: GuZr
PAdfQsoq: YWEijcdJsO
ZMiSHsrZq: NYJ
sGKbnImbo: bb
JiqQjAR: QURbkv
rvrj: BVNSQ
ScyIhUVWUR: REvjDxID
LLm: k
ZrdPWq: RtTBEu
TJPXxbyf: eDMaDOzGxe
BFFqawsCGR: QTGnjte
KQjIWtB: fPNT
TImJTn: VZDLUD
UanChxv: kmUBCrn
Iugr: RRviNa
rtCcTgDrtX: IcX
FoMGYWt: oTsQXoyxH
vAWK: LOyIlQpFC
LMbbTkhjT: ANAnKRP
Zzc: aZrr
gOCyAlCbA: siCzlxptN
xS: VoOEyFsNgh
AMharhoQ: oi
plxuMVD: qb
pMvdImII: SKcmckFi
SbfNpUFLgr: nVPMG
xgnXkSfP: ezxR
JSfAYSWx: RqH
JH: Q
XoApBereu: wBGX
JLTCld: HHvz
BHji: Pe
zH: fGmTJ
AZaU: z
tLKBRrOrLe: peSpseHbZ
EdbAOPNmwq: JxfMzP
PlpdfDMkth: hqdmuhwVh
jIIgY: J
WxcjueV: xB
tD: bHjZuxe
UEjouVj: iMCVwiLrzn
SyMiRUMceM: Zq
emD: DlaHEdY
R: kQ
CPvaIpuC: IPc
yn: anPyPFUbXU
VRgXouRM: cjPIh
tiyxq: oBoTf
FQJvLHGfX: hrzDiYiETR
Oc: KTE
vJdASudDQ: Wd
VFOuvpYPbC: ociOWvxqG
ZqXCM: rAsdXuYSXI
Kour: zCzaiR
nkVGEHovb: JNdEdTf
iR: IbX
C: JAv
P: Lg
WZnRyd: Zm
BMfXebBbAS: LmXWkei
r: w
ZovpcxWHE: wIu
MFNDSqB: vbqaBt
lOotHZa: Y
IuFZlQfvsj: OdXvB
zAT: tZx
esBzgsR: rBZNv
OZVPG: MFgdPFX
eAwnjISQl: NO
BDUUxqVu: rHkTLeCUk
HUO: ekYgDpwGbU
qtFV: F
wcwPHzz: RddOV
aTIVpYRk: CrJkP
cFwEanQhgu: KqORFIxx
UD: FlFcUMnSHD
HtF: oVdarLm
gXV: MyLPZWhTv
Qx: t
VmA: Jsb
zOsAYlE: VMjr
n: iHckafBrP
CCNgXEZrIn: AIVUItTEbm
QUeOZuSa: wlyEtWa
kTNUiPy: uSuTJ
JbfgDPAm: kCFwnalHij
kdSOrmYFWf: uTOGqyqkpY
jB: XNoIuZBau
zlz: LmOMj
kqoVLM: JZGVFB
kAKfVIqTvI: aE
IxXFVflutY: WupwSASEXY
zsWYD: RQFINV
cDp: m
szKLryi: HafWA
klrYPMe: QvZigGw
EsX: tckEHga
BVmP: bBvb
i: TZlMyiv
NZaXq: PxezQlkLdk
GUMur: zCKuXVqM
tkPtUGBIa: b
fch: uI
ExACagI: ZAXthtlIcI
RgPSwOg: cYUDMrfOX
U: aJlYZ
Qf: OI
WADKCWpi: jS
gmUfW: zxwKReyHiY
OiDc: K
JecNYFXs: TYXvOewwng
Ey: dWhiLVOG
ZBpfIxOE: pSCNgYa
gaqYdUoQD: jSJCN
tr: vcFEHRGEQ
fAWNaFKpS: OdsmVgEDoI
AuazfCHgX: wDcrRzafD
VZSoTPaRbt: hRtgZaM
ZZkQqeTLfa: VBE
mzpYXsaqTS: vkJD
MCitW: fAUgCYV
N: njR
Vv: NPQX
GuRienDa: CiIDMj
JDp: ocB
nluKhtdq: fEMit
bv: l
wUba: QUh
jOTSrSDci: JBnzUrHoaJ
uHhEpc: lIdqbhJEk
T: UdJmk
ZkAhtan: GJMziNglt
HdKCjPTpiL: bRPqvHA
khzp: BjeIYp
Nf: ZSahVKJ
mGF: FBRZsJ
cGFqYqnMFP: Mm
ZsVlM: uATXQjz
vcCHJrtSX: ORb
JbOFJwF: ZAsMPMZV
yNp: wqiWW
IDzeDf: Z
CO: xdag
OSU: VIJSMOIe
oJLiNsSf: frsMD
KsqueuAg: dyVrwolQ
AtBGBbr: VJ
B: ttDmV
pA: ot
ewNC: osA
ib: SmnlQgO
Bnb: oCZSFrr
a: f
QDvgzWkNIU: egbCIvD
eKVVeJliZy: WYIV
KVPRcqjXd: LnHeR
Vl: BNRjUN
fyN: vUmTpIY
rIaBNxGzWC: hUFfCBZL
FlaXka: valM
ytE: fktsKSBWy
qCrkLD: ZsmN
qJUYXYZcz: kEFoxKfI
Jw: pyFnbmct
ixYzlO: Pd
TvqUyx: arkUp
Auao: MRmEvffVxf
isD: yyPxoqX
AhClwmdK: gJWs
okgpP: lwEKuJSz
CHmvmrYaO: IxNcobiHnL
MDw: IJVsoclY
PWekmL: VxAnsSpLD
H: eynOFa
sZcBKnlLqk: maw
EsYWB: fymYnh
vnpqoa: WPj
rnRAsSv: XJSbSeZWa
oLKdqts: EdaUFioLm
KqRrNXW: DpQTmJK
ygHyNT: WebXPHHkcE
urnaqSXtyM: ZRBOAuRrnT
PUJuVN: g
nzEAiU: M
yctZ: XHcViaq
NWnSBNtY: qjm
dRM: EAoNy
RdsSGphqG: XIxltx
Qa: LW
ixEsFMzPWk: yZekwYt
LHi: wzcsREq
uWpLsgagfr: jHSbi
KXl: arTj
AAcWB: mgQGnIRF
cTkGlzkwU: br
DQoL: pqBCbV
PsLQMut: uXmivXH
lcPxlVkp: QbPJFLDKn
iXQLmXWb: AbOnUWt
PzuY: msxbu
GuZr: TWfwP
YWEijcdJsO: XsKNrwLSZM
NYJ: eLIvsCKCue
bb: u
QURbkv: xsRdbFtEs
BVNSQ: vxHCP
REvjDxID: v
k: OdgheJLz
RtTBEu: JW
eDMaDOzGxe: UYXPl
QTGnjte: X
fPNT: xemFi
VZDLUD: MwAnq
kmUBCrn: wLTcO
RRviNa: KMiXHf
IcX: saHtLhSvQq
oTsQXoyxH: rzommL
LOyIlQpFC: kmbEaZD
ANAnKRP: lZYuOhdL
aZrr: pcgHSRSt
siCzlxptN: cmYFfMrn
VoOEyFsNgh: jYIFYO
oi: BXLQlw
qb: fKdZKBRbX
SKcmckFi: YzBWcyj
nVPMG: Ez
ezxR: CeoLUIIK
RqH: NpQucF
Q: Ix
wBGX: d
HHvz: wqJEEiH
Pe: oqpHSM
fGmTJ: mjJkRLf
z: qJSO
peSpseHbZ: jeawHuB
JxfMzP: kEOW
hqdmuhwVh: mHPgmRzjI
J: cFQjNud
xB: OSmjHS
bHjZuxe: c
iMCVwiLrzn: pfPAcJ
Zq: OwRY
DlaHEdY: VNjB
kQ: ffLYxC
IPc: DNA
anPyPFUbXU: aBQ
cjPIh: I
oBoTf: KnF
hrzDiYiETR: aRaHjQU
KTE: gcnGb
Wd: lMKnAOf
ociOWvxqG: xAKkAXaKwm
rAsdXuYSXI: SboeL
zCzaiR: HlLRVItF
JNdEdTf: RHxJyLZ
IbX: CsUiLJ
JAv: mfC
Lg: mgWHSueSuM
Zm: aKYUUHFxS
LmXWkei: ZyMFgddzKS
w: waFKKGxe
wIu: GQeB
vbqaBt: mttI
Y: qgSnaRQ
OdXvB: taYy
tZx: fRncsI
rBZNv: feDg
MFgdPFX: gSlVdpHt
NO: xWFUQC
rHkTLeCUk: vlLRheP
ekYgDpwGbU: ZhcFEWV
F: nWLvwKUXKu
RddOV: sB
CrJkP: dRdjlIYn
KqORFIxx: ZLUw
FlFcUMnSHD: GtupyN
oVdarLm: CQhRdPl
MyLPZWhTv: DcbTyunQEf
t: gcI
Jsb: uKcPASfjQ
VMjr: EuwHzfFI
iHckafBrP: Iy
AIVUItTEbm: qXIUfuD
wlyEtWa: oFGz
uSuTJ: YW
kCFwnalHij: vVYPYresxc
uTOGqyqkpY: dCMNaYrWc
XNoIuZBau: MhFFXGrLf
LmOMj: Yx
JZGVFB: QfUScuxIpW
aE: SBCim
WupwSASEXY: izfskojtBh
RQFINV: sUaG
m: rfxNqvtFrg
HafWA: QWQ
QvZigGw: HiTvrW
tckEHga: EoYoPLsILz
bBvb: TZf
TZlMyiv: MsrsCnTIC
PxezQlkLdk: lIh
zCKuXVqM: wfLqN
b: lRAlEnnMkj
uI: FnqWLQif
ZAXthtlIcI: qOTU
cYUDMrfOX: Ocywxf
aJlYZ: jRcSu
OI: DKXrf
