ENCODE
PvOkJ: NBtXpFAK wxLTZDt zJaO VkUkqr PkoYrjpt IplhOMgMgF KlPHw A wPm sSKGxDGY JlzIXcUVVM IEVQUWBZH
NBtXpFAK: FdGUm
PkoYrjpt: ven
KlPHw: FoG
JlzIXcUVVM: sXTBY
IEVQUWBZH: zume
sSKGxDGY: sE
wxLTZDt: MDJMRS
zJaO: DRsIc
VkUkqr: uTK
IplhOMgMgF: INZEjiYnd
A: VQeTeYwb
wPm: SX
FdGUm: cJLkGy
ven: kQszEdO
FoG: Pbnrwy
sXTBY: JAgECP
zume: EUMVPT
sE: OmniuHg
MDJMRS: DXxj
DRsIc: sfN
uTK: MkRJpSgDO
INZEjiYnd: L
VQeTeYwb: sDiTkc
SX: sjDSCVqhC
cJLkGy: USa
kQszEdO: nG
Pbnrwy: amEXAr
JAgECP: YoZWZZUOFm
EUMVPT: eMLfRq
OmniuHg: j
DXxj: DW
sfN: tLGWrxz
MkRJpSgDO: pPStNMd
L: FTxQAJ
sDiTkc: YB
sjDSCVqhC: uNHrhNlX
USa: FaGavuHO
nG: q
amEXAr: Zz
YoZWZZUOFm: nUgYuderaW
eMLfRq: BvgxRLHUr
j: VRsosBbc
DW: gJeDD
tLGWrxz: IBWSLlG
pPStNMd: TtV
FTxQAJ: SSZvGdQJio
YB: JtSuZpkbw
uNHrhNlX: ygjMqGJRE
FaGavuHO: uKawVN
q: uh
Zz: hLHfpzJV
nUgYuderaW: Piswir
BvgxRLHUr: s
VRsosBbc: sDTIfOoEC
gJeDD: WMGzbmNuc
IBWSLlG: FLtz
TtV: yCHHzEgcxy
SSZvGdQJio: ACOVy
JtSuZpkbw: dNe
ygjMqGJRE: QL
uKawVN: fsVcKWyCfu
uh: oxuMal
hLHfpzJV: zLGxmWR
Piswir: RyfzFFr
s: mUCylEFyp
sDTIfOoEC: xGhxZc
WMGzbmNuc: CjAC
FLtz: jblgILWyi
yCHHzEgcxy: ZpPJPXnYpm
ACOVy: AEsQa
dNe: gDB
QL: FhcD
fsVcKWyCfu: sHPKimh
oxuMal: WbrrIuW
zLGxmWR: BQC
RyfzFFr: ItUw
mUCylEFyp: xzBQQPvv
xGhxZc: zYTh
CjAC: uabc
jblgILWyi: BiIbOXgT
ZpPJPXnYpm: rogqGKop
AEsQa: pNS
gDB: JZjAQGTzEd
FhcD: aqGwqfw
sHPKimh: LEwjpjQ
WbrrIuW: deLrJCgrs
BQC: jgJIf
ItUw: mYtOS
xzBQQPvv: iErXNZ
zYTh: AEAgHBnVS
uabc: JuzIz
BiIbOXgT: JyYo
rogqGKop: fwoqrH
pNS: Cwa
JZjAQGTzEd: zrjiql
aqGwqfw: rTMIvoMR
LEwjpjQ: hY
deLrJCgrs: FjoUcnZO
jgJIf: VJRr
mYtOS: qnvW
iErXNZ: jVhPNKB
AEAgHBnVS: DtXhc
JuzIz: hWzZBLrGd
JyYo: OTJHGDGrbj
fwoqrH: WeH
Cwa: xVeLfsn
zrjiql: lwEMgGdmab
rTMIvoMR: R
hY: ELJVQI
FjoUcnZO: Somcsw
VJRr: UvoCgu
qnvW: DdDyt
jVhPNKB: lFTTwbXDI
DtXhc: Zk
hWzZBLrGd: eNRZXlcdVi
OTJHGDGrbj: zxJTefepGr
WeH: Vz
xVeLfsn: nFlAHdJ
lwEMgGdmab: C
R: ows
ELJVQI: ilO
Somcsw: IKJ
UvoCgu: gOe
DdDyt: VJD
lFTTwbXDI: dOx
Zk: YvMrmYoR
eNRZXlcdVi: RPX
zxJTefepGr: XYddiCc
Vz: OSLnZdFY
nFlAHdJ: cOp
C: JEqAGr
ows: TyB
ilO: eMGJH
IKJ: n
gOe: MlhczG
VJD: fY
dOx: GLg
YvMrmYoR: NfTydKLA
RPX: rU
XYddiCc: Fn
OSLnZdFY: jyxeMo
cOp: DTpIhCnrq
JEqAGr: LHpkCyvqyW
TyB: PCZVQm
eMGJH: iiMy
n: uZHq
MlhczG: RuUj
fY: Mqu
GLg: iM
NfTydKLA: ydh
rU: jmMO
Fn: YtQDbLXd
jyxeMo: U
DTpIhCnrq: rPcI
LHpkCyvqyW: fqy
PCZVQm: pSXTjZZp
iiMy: hG
uZHq: TFJ
RuUj: Yana
Mqu: BpmHryVUo
iM: toezmGAUb
ydh: jRPRdbMfxC
jmMO: fcEmIfjYnL
YtQDbLXd: IltWPh
U: dQsEYYZ
rPcI: ZZiMlG
fqy: JNjVJpl
pSXTjZZp: uQ
hG: WzTg
TFJ: AxoQJh
Yana: Qrt
BpmHryVUo: Bvmh
toezmGAUb: T
jRPRdbMfxC: aRZX
fcEmIfjYnL: bUhpj
IltWPh: VDGThXHJf
dQsEYYZ: vbVVEwoo
ZZiMlG: cGHf
JNjVJpl: bOMCWdkOh
uQ: mVkarE
WzTg: cTcQVcEQ
AxoQJh: guuJN
Qrt: QuwikcRko
Bvmh: mBbNI
T: wYLFPyJGFr
aRZX: wy
bUhpj: pJcMIYvh
VDGThXHJf: Hz
vbVVEwoo: mJD
cGHf: vmRDnouut
bOMCWdkOh: pf
mVkarE: oDJbrWQ
cTcQVcEQ: GbJBRfzT
guuJN: da
QuwikcRko: WxAOlVTSdh
mBbNI: HncyrGYH
wYLFPyJGFr: a
wy: WTQrZkbSRe
pJcMIYvh: sMMpMszyOB
Hz: FOb
mJD: TefBiJftj
vmRDnouut: dQFwiayEC
pf: ukgylIb
oDJbrWQ: AIwHtuzau
GbJBRfzT: PAeOcEJU
da: XAqDZi
WxAOlVTSdh: Wz
HncyrGYH: Iu
a: zjf
WTQrZkbSRe: S
sMMpMszyOB: keiuUHIDU
FOb: fKk
TefBiJftj: CTNOZuqG
dQFwiayEC: fxcAEqjk
ukgylIb: QjE
AIwHtuzau: gNJoBTP
PAeOcEJU: yVfS
XAqDZi: SrlWck
Wz: ISXCogMvuM
Iu: H
zjf: wOSmiVWvTD
S: OZSi
keiuUHIDU: PAySIwcLDS
fKk: HzbKpiNznO
CTNOZuqG: xJrDDBxMMQ
fxcAEqjk: GoGEh
QjE: cjc
gNJoBTP: HwVi
yVfS: VETRPloJ
SrlWck: ptzwusVovG
ISXCogMvuM: zzvypWJ
H: cerLsEfaAB
wOSmiVWvTD: jWOINpiswZ
OZSi: ULMNlXqT
PAySIwcLDS: wOwy
HzbKpiNznO: OqscpenF
xJrDDBxMMQ: iOVRMrthW
GoGEh: GFLHTcI
cjc: jUiGwMuTT
HwVi: xkOXwOPw
VETRPloJ: qTWrR
ptzwusVovG: WgBHjX
zzvypWJ: RQxCbJW
cerLsEfaAB: PGcG
jWOINpiswZ: kZ
ULMNlXqT: NGq
wOwy: wkq
OqscpenF: tsix
iOVRMrthW: ksyd
GFLHTcI: qcPEJTD
jUiGwMuTT: MMKC
xkOXwOPw: AOmDdCiZ
qTWrR: tsVAd
WgBHjX: JSiSFV
RQxCbJW: GPeebhj
PGcG: oGomiVXiD
kZ: Okt
NGq: ovUczpxw
wkq: p
tsix: pQdeC
ksyd: rPVDMctFv
qcPEJTD: YVtM
MMKC: BApEKGDj
AOmDdCiZ: Zj
tsVAd: HjDkBSLNpP
JSiSFV: vjZrRz
GPeebhj: hWdozaLzYD
oGomiVXiD: Kc
Okt: HMlCkYmOg
ovUczpxw: XA
p: cYafSg
pQdeC: Q
rPVDMctFv: nwxs
YVtM: MVqC
BApEKGDj: axiZEcM
Zj: cyRDN
HjDkBSLNpP: ItkSX
vjZrRz: cbAv
hWdozaLzYD: J
Kc: ZrJiSzSVJj
HMlCkYmOg: zpWrSUbid
XA: NU
cYafSg: bkv
Q: XRcsFJ
nwxs: aPkjaCwjMP
MVqC: hj
axiZEcM: KCAyzMT
cyRDN: kQ
ItkSX: nCaVz
cbAv: aeBcbhR
J: bX
ZrJiSzSVJj: pljc
zpWrSUbid: ioDVE
NU: yl
bkv: QkdwPVkhsn
XRcsFJ: o
aPkjaCwjMP: GiU
hj: gwPdq
KCAyzMT: LqZNwb
kQ: OXSKumTSW
nCaVz: BFGDsgv
aeBcbhR: Wn
bX: gjcVvxEbmv
pljc: YtrKNTIL
ioDVE: KfyEhWPup
yl: fQtiMee
QkdwPVkhsn: mpSzBAy
o: cFNaQlk
GiU: EWfJAl
gwPdq: EIxTFqVxMJ
LqZNwb: ZAgGFHi
OXSKumTSW: SRt
BFGDsgv: dltSjm
Wn: Y
gjcVvxEbmv: CWenwxKr
YtrKNTIL: CDD
KfyEhWPup: dRmi
fQtiMee: YzZcf
mpSzBAy: XZ
cFNaQlk: RtBUayUVsd
EWfJAl: blP
EIxTFqVxMJ: tqSegZw
ZAgGFHi: zshfrw
SRt: bIR
dltSjm: IXD
Y: Au
CWenwxKr: mA
CDD: NfhYIWL
dRmi: jEfrRdOUq
YzZcf: F
XZ: oVSKvam
RtBUayUVsd: co
blP: apnMLsu
tqSegZw: AWHxx
zshfrw: supgASotF
bIR: wmDN
IXD: t
Au: Bmn
mA: yCHJQQwprq
NfhYIWL: yQWCGysUj
jEfrRdOUq: crtgqfPqEN
F: cAHzulCl
oVSKvam: fl
co: KBiodwO
apnMLsu: kJTk
AWHxx: qIhp
supgASotF: O
wmDN: BVqOhY
t: hUJhioZW
Bmn: Fwkb
yCHJQQwprq: Mcx
yQWCGysUj: LKYO
crtgqfPqEN: uLgnEuJ
cAHzulCl: gKZYaQt
fl: m
KBiodwO: XvXF
kJTk: uwqCfUNnNH
qIhp: NeSavTBmsj
O: PXWPWDlDe
BVqOhY: PjR
hUJhioZW: edG
Fwkb: XUlSG
Mcx: Jpv
LKYO: uHvce
uLgnEuJ: gBk
gKZYaQt: b
m: ZyEeZiW
XvXF: dpcTJnrZ
uwqCfUNnNH: uI
NeSavTBmsj: tNJ
PXWPWDlDe: qOuk
PjR: IvdW
edG: mSl
XUlSG: ktfPMvnVnj
Jpv: jd
uHvce: mXKdXiwbv
gBk: fRlJbM
b: LDEir
ZyEeZiW: K
dpcTJnrZ: gEEuJfZFUJ
uI: PVY
tNJ: KpVrTI
qOuk: EJPhrrquU
IvdW: SLoCpiK
mSl: BCTwnrBWRg
ktfPMvnVnj: Sy
jd: ohvY
mXKdXiwbv: UOtGmWgM
fRlJbM: xBC
LDEir: yLx
K: welrnIQ
gEEuJfZFUJ: wqiAt
PVY: hNdehXVVD
KpVrTI: roKI
EJPhrrquU: Nb
SLoCpiK: dQjr
BCTwnrBWRg: GQxnO
Sy: MOnli
ohvY: qxy
UOtGmWgM: oxDbOeCt
xBC: HOKwx
yLx: MaGWQSZ
welrnIQ: tUlS
wqiAt: RUVGpqeWg
hNdehXVVD: aIyL
roKI: pqiQdcl
Nb: ALwcyxy
dQjr: UOkXRf
GQxnO: YLPR
MOnli: TPSjcAS
qxy: zIHemiNh
oxDbOeCt: RWnLw
HOKwx: ZSAgFOdxWV
MaGWQSZ: pV
tUlS: zpyQXZ
RUVGpqeWg: DGPCyBXMOV
aIyL: snhT
pqiQdcl: dlkZfoGNn
ALwcyxy: kjJzfee
UOkXRf: HFMQt
YLPR: OdoSezzM
TPSjcAS: kaXDP
zIHemiNh: JRva
RWnLw: rQIfLoW
ZSAgFOdxWV: CxctylSpTN
pV: Yj
zpyQXZ: MZsj
DGPCyBXMOV: dysQvxAAin
snhT: HKnEAe
dlkZfoGNn: XLdfIMVoVr
kjJzfee: AAFiMP
HFMQt: AgqFaor
OdoSezzM: js
kaXDP: gIFfYpXij
JRva: iTizw
rQIfLoW: WJgTFnHG
CxctylSpTN: yyAK
Yj: XCkxvnOt
MZsj: cwb
dysQvxAAin: cuwZkLm
HKnEAe: KyOmo
XLdfIMVoVr: g
AAFiMP: M
AgqFaor: idWYo
js: whVNKGe
gIFfYpXij: hVdwmpE
iTizw: D
WJgTFnHG: yPfWMEjOq
yyAK: dlgMyO
XCkxvnOt: hbJB
cwb: CpfefHeO
cuwZkLm: vLAR
KyOmo: vBxtM
g: Yhes
M: Cxcffoih
idWYo: zeNBIMO
whVNKGe: uF
hVdwmpE: DZnxNHtx
D: ZQ
yPfWMEjOq: cZq
dlgMyO: MwkkzrLr
hbJB: xKal
CpfefHeO: oPqLIJPN
vLAR: u
vBxtM: JW
Yhes: v
Cxcffoih: mMBtX
zeNBIMO: ZGaheRQm
uF: iZboRz
DZnxNHtx: JcenHZg
ZQ: qSGeBgo
cZq: shArddsJKo
MwkkzrLr: DjKJCuadci
xKal: ndiHTqr
oPqLIJPN: eoOA
u: KXsk
JW: aKt
v: eHoIgNE
mMBtX: NSBhhK
ZGaheRQm: AkGX
iZboRz: XjpXXV
JcenHZg: CYXkMVahs
qSGeBgo: eJoyGTKRl
shArddsJKo: VYiiQZo
DjKJCuadci: OFZg
ndiHTqr: Ez
eoOA: rbXBNTxK
KXsk: oM
aKt: aL
eHoIgNE: ZBWsUJV
NSBhhK: flZ
AkGX: jttHrNUAc
XjpXXV: EqV
CYXkMVahs: nGoL
eJoyGTKRl: dcjouebMw
VYiiQZo: V
OFZg: MRW
Ez: aTReIAs
rbXBNTxK: dyHDiaA
oM: xdVYxVr
aL: ha
ZBWsUJV: DF
flZ: WeHPt
jttHrNUAc: QCgj
EqV: DqBxDi
nGoL: nXInvTH
dcjouebMw: YMc
V: HvwzSU
MRW: VZkWdJp
aTReIAs: PPxZOfz
dyHDiaA: VTWDBAjx
xdVYxVr: KHywGHUs
ha: xUpOrl
DF: bEyp
WeHPt: tNucFG
QCgj: iuxIXpYnCk
DqBxDi: hIpb
nXInvTH: bmttajFex
YMc: nTrg
HvwzSU: tiowj
VZkWdJp: I
PPxZOfz: fEJG
VTWDBAjx: fXg
KHywGHUs: XhcdtOd
xUpOrl: BCtoKl
bEyp: UQbayCr
tNucFG: pQ
iuxIXpYnCk: lTsjiekQ
hIpb: Yb
bmttajFex: Qyfo
nTrg: FOEq
tiowj: fJRJNHO
I: eTqcDc
fEJG: cKLj
fXg: wzxMPp
XhcdtOd: OSbxpEj
BCtoKl: qsujjSKa
UQbayCr: DLTi
pQ: JJJB
lTsjiekQ: sm
Yb: EpP
Qyfo: jYKLDP
FOEq: Fax
fJRJNHO: sgNi
eTqcDc: BCGZSLL
cKLj: OKip
wzxMPp: VxeoZZdkb
OSbxpEj: ZvN
qsujjSKa: CMvlHB
DLTi: RJQHGc
JJJB: LBjb
sm: EecRcD
EpP: CnZwopt
jYKLDP: oRqWOEtt
Fax: TnowKMDf
sgNi: jQr
BCGZSLL: JUY
OKip: XV
VxeoZZdkb: wNvDJliCF
ZvN: Tf
CMvlHB: zGsnsPxCA
RJQHGc: dpd
LBjb: wIAfs
EecRcD: pYdqoZmm
CnZwopt: wjkjtk
oRqWOEtt: PE
TnowKMDf: EVnCrn
jQr: WTQzsYPWSp
JUY: yCiJGAXauS
XV: ObV
wNvDJliCF: AYKOWl
Tf: wmthnzK
zGsnsPxCA: DpT
dpd: TSM
wIAfs: zjMaUSg
pYdqoZmm: ZmZoaRpz
wjkjtk: Qfxq
PE: MynHdnIrXR
EVnCrn: UlvvmtS
WTQzsYPWSp: PFkmPP
yCiJGAXauS: yXyRjTeI
ObV: ts
AYKOWl: EnlHBQ
wmthnzK: cgX
DpT: fjQ
TSM: wFmH
zjMaUSg: FhENvSiB
