ENCODE
tb: jzoCimeufq mKzfYENBfM Bk QOapqbeYF uTHA Cit ZFcHAobaMn kca
jzoCimeufq: FNHLe
mKzfYENBfM: GwqDxFNP
Bk: IuzAxLpF
QOapqbeYF: MdfuRMzi
uTHA: rs
Cit: yf
kca: gWddzRblr
ZFcHAobaMn: eqx
FNHLe: lvOwRrjz
GwqDxFNP: FYwM
IuzAxLpF: XdP
MdfuRMzi: EHkljsXkbe
rs: qeWu
yf: mBCKL
gWddzRblr: GzNEiH
eqx: RBlWqFdvA
lvOwRrjz: ale
FYwM: CpEqHS
XdP: TdQGBYcza
EHkljsXkbe: vJsixrjPc
qeWu: csNLnvArrL
mBCKL: hvRtEYs
GzNEiH: fbTYStW
RBlWqFdvA: McNqNWZ
ale: IW
CpEqHS: iZeeJUe
TdQGBYcza: L
vJsixrjPc: PMwBSmyF
csNLnvArrL: akhaZ
hvRtEYs: fxh
fbTYStW: WFxpZJ
McNqNWZ: NRw
IW: Gr
iZeeJUe: ofvkO
L: AA
PMwBSmyF: JLKx
akhaZ: MvR
fxh: OYDNIEd
WFxpZJ: WrfKAFeDd
NRw: DawNU
Gr: uEtk
ofvkO: hly
AA: Mb
JLKx: dO
MvR: RsfQYEi
OYDNIEd: q
WrfKAFeDd: kfbXjyZ
DawNU: UCwVsKxXb
uEtk: cVfbvGC
hly: Tcly
Mb: YSuCh
dO: OqEllHEF
RsfQYEi: jz
q: esCjQ
kfbXjyZ: SXLk
UCwVsKxXb: kKvLirhdt
cVfbvGC: oRRP
Tcly: WS
YSuCh: XyNWP
OqEllHEF: NrNVvEBtoj
jz: mHpBb
esCjQ: EKuncmomKy
SXLk: INjFbxyR
kKvLirhdt: E
oRRP: rvFctUBB
WS: HV
XyNWP: mMFUTg
NrNVvEBtoj: tKnaM
mHpBb: hLrcZuYSBL
EKuncmomKy: BYLcINGlP
INjFbxyR: TyNbdI
E: hjAC
rvFctUBB: HQt
HV: vOqlQvxIM
mMFUTg: LWbBKoLz
tKnaM: AY
hLrcZuYSBL: YJMZeTGFHo
BYLcINGlP: DGZiudJ
TyNbdI: fKNX
hjAC: CodgRHKxhE
HQt: Pc
vOqlQvxIM: vEhMsuOn
LWbBKoLz: nTjhIBBi
AY: kHJVbaP
YJMZeTGFHo: LXD
DGZiudJ: DPZi
fKNX: iGgX
CodgRHKxhE: AWUfRlzEu
Pc: gMEqApM
vEhMsuOn: ewzeANw
nTjhIBBi: bN
kHJVbaP: jzp
LXD: dsDHGtLjMf
DPZi: XLJZGtqR
iGgX: dqah
AWUfRlzEu: jzAcbmq
gMEqApM: giWiR
ewzeANw: zjfvnI
bN: LtamdrujD
jzp: dfCRZOMBfo
dsDHGtLjMf: XcXLbTA
XLJZGtqR: y
dqah: ZuaSCRPdD
jzAcbmq: VPtIddM
giWiR: otWQObK
zjfvnI: PRLDhX
LtamdrujD: TZvnCfKCW
dfCRZOMBfo: LryvYcA
XcXLbTA: dNSl
y: VgtgQV
ZuaSCRPdD: RbrjBjUsd
VPtIddM: hTQXJVz
otWQObK: Gi
PRLDhX: VFIdnqfcR
TZvnCfKCW: YfmyUh
LryvYcA: BHL
dNSl: aGXt
VgtgQV: khT
RbrjBjUsd: UKAp
hTQXJVz: peltxSfX
Gi: pTEWTNLgrM
VFIdnqfcR: KbEgkobJY
YfmyUh: wZZE
BHL: eNMPpmSSs
aGXt: TnXLhPCE
khT: AWQlFXl
UKAp: DRVV
peltxSfX: gjiq
pTEWTNLgrM: wpSvDtDWJr
KbEgkobJY: WDaEcgq
wZZE: oKXSHlcBj
eNMPpmSSs: Pz
TnXLhPCE: qGXY
AWQlFXl: hHicNDAV
DRVV: BH
gjiq: wWrKpFtQX
wpSvDtDWJr: KUOFdLEPx
WDaEcgq: dFqAol
oKXSHlcBj: RUZiof
Pz: InPVB
qGXY: R
hHicNDAV: Lz
BH: IFpUYsA
wWrKpFtQX: eWzYTYfnyt
KUOFdLEPx: cZDti
dFqAol: ORFWwjAKX
RUZiof: pPpXrUyt
InPVB: NpYcG
R: vujLpCdfQV
Lz: vQRYUB
IFpUYsA: cTy
eWzYTYfnyt: cVZrNGaYs
cZDti: pQjHfLm
ORFWwjAKX: jVVVhSodKp
pPpXrUyt: h
NpYcG: NNDYVguIz
vujLpCdfQV: AD
vQRYUB: C
cTy: IKJDc
cVZrNGaYs: tyX
pQjHfLm: P
jVVVhSodKp: WcMuLKnkz
h: r
NNDYVguIz: ade
AD: eawAToDl
C: ckxbfDStF
IKJDc: GaXb
tyX: ugmBk
P: dtKVRbaAM
WcMuLKnkz: OnvCwJ
r: gM
ade: wK
eawAToDl: yQ
ckxbfDStF: FHDzKbe
GaXb: sIiZ
ugmBk: DUCCnyPRhz
dtKVRbaAM: iTVOcRRb
OnvCwJ: qkeSDLO
gM: MEAwosKYrm
wK: ljh
yQ: amKdcS
FHDzKbe: NNYoLzG
sIiZ: n
DUCCnyPRhz: VBy
iTVOcRRb: zizg
qkeSDLO: vs
MEAwosKYrm: LruzR
ljh: BKnAR
amKdcS: Mr
NNYoLzG: MygliSS
n: i
VBy: AGjVLq
zizg: RLUjz
vs: iVMomVaCr
LruzR: LEAyOcYS
BKnAR: hBDqyxGdBZ
Mr: U
MygliSS: dzGeLBFUx
i: nwrNKY
AGjVLq: fSXITehHyM
RLUjz: IsCuWopu
iVMomVaCr: rSOckU
LEAyOcYS: QeSLNS
hBDqyxGdBZ: zzoJ
U: VgbmNNknlA
dzGeLBFUx: cewJdrY
nwrNKY: kdIRcw
fSXITehHyM: fcbTObvdNb
IsCuWopu: vzcU
rSOckU: mbHtP
QeSLNS: nsTnRv
zzoJ: N
VgbmNNknlA: BPYMs
cewJdrY: FRsg
kdIRcw: KyHvcr
fcbTObvdNb: HjFRXwVaZE
vzcU: pRAPHPPW
mbHtP: T
nsTnRv: SnKmgJ
N: ETHFxnlkp
BPYMs: IZfq
FRsg: XY
KyHvcr: RbTHua
HjFRXwVaZE: JKSyb
pRAPHPPW: VEI
T: SipEriUaDA
SnKmgJ: dCa
ETHFxnlkp: sReVynP
IZfq: oyAQuuaW
XY: us
RbTHua: QjBFiMG
JKSyb: Hz
VEI: B
SipEriUaDA: kD
dCa: yTXgOFHKV
sReVynP: gPtPO
oyAQuuaW: EpfsDYbs
us: yVOVF
QjBFiMG: YTvx
Hz: QpY
B: ctXIFLkyd
kD: JqFjm
yTXgOFHKV: rxxIIsjfe
gPtPO: djlwOW
EpfsDYbs: ztjCyF
yVOVF: HQ
YTvx: xtPvnVfVBJ
QpY: uUTZFOow
ctXIFLkyd: S
JqFjm: rHfUVqp
rxxIIsjfe: lgCII
djlwOW: RV
ztjCyF: ejDUYAbNr
HQ: H
xtPvnVfVBJ: RULqUgQ
uUTZFOow: ZRGITkQrz
S: Iv
rHfUVqp: bhLuIiXPVU
lgCII: tHhxsjn
RV: EfTtPJUlq
ejDUYAbNr: zqMRT
H: vvX
RULqUgQ: xBVJmOspX
ZRGITkQrz: wlukykNX
Iv: KBLsxR
bhLuIiXPVU: UvZeYItn
tHhxsjn: Zlre
EfTtPJUlq: BkrmoZQF
zqMRT: yNoXH
vvX: tublMqESf
xBVJmOspX: wzajrmwQ
wlukykNX: Fehl
KBLsxR: EfpmktLlu
UvZeYItn: tqdhQKNm
Zlre: DZJLHSfe
BkrmoZQF: fWRCxb
yNoXH: rDyqjvkMpE
tublMqESf: szeZfl
wzajrmwQ: TeO
Fehl: LehJaSWh
EfpmktLlu: NDD
tqdhQKNm: PQkTDc
DZJLHSfe: Jnl
fWRCxb: Yo
rDyqjvkMpE: mIkwr
szeZfl: XRi
TeO: wussCZFrl
LehJaSWh: sF
NDD: tOqU
PQkTDc: YARCJ
Jnl: Cn
Yo: ODbT
mIkwr: hXIan
XRi: xOZAGBOz
wussCZFrl: KcXr
sF: clZcoyYq
tOqU: ziy
YARCJ: CVhba
Cn: k
ODbT: nboCZzCPA
hXIan: xAIHwN
xOZAGBOz: QNEndAgU
KcXr: fvXpSvOM
clZcoyYq: zuIJgcbT
ziy: aOw
CVhba: p
k: Vgs
nboCZzCPA: RCQNFqWQ
xAIHwN: oAXdrRrOT
QNEndAgU: pyaojqqOWh
fvXpSvOM: Wwl
zuIJgcbT: hlk
aOw: NF
p: Q
Vgs: Nsr
RCQNFqWQ: mqJYNuTcs
oAXdrRrOT: TBqquCSXb
pyaojqqOWh: J
Wwl: WehfFgg
hlk: FXJNDI
NF: RwCIhI
Q: uqkZeQq
Nsr: FxMSZY
mqJYNuTcs: SGKpBMlX
TBqquCSXb: TiAooe
J: PVuqkHFgP
WehfFgg: bygn
FXJNDI: BcKZD
RwCIhI: xwom
uqkZeQq: HD
FxMSZY: dRe
SGKpBMlX: LKVVGl
TiAooe: pfIk
PVuqkHFgP: fMTqKRM
bygn: BUvt
BcKZD: o
xwom: xfnefC
HD: qD
dRe: CYftos
LKVVGl: AfVJcGj
pfIk: yNkfsRWm
fMTqKRM: kI
BUvt: YF
o: sLOYVfoYf
xfnefC: eMboS
qD: yg
CYftos: fJjv
AfVJcGj: hoMQmW
yNkfsRWm: BIgStqKwN
kI: xrPJ
YF: Y
sLOYVfoYf: aO
eMboS: LO
yg: eKzKvBZ
fJjv: QngPTAhJ
hoMQmW: KQwVMsthb
BIgStqKwN: vleMSgMgu
xrPJ: BB
Y: lFhAk
aO: sAKvv
LO: tWsJygFcr
eKzKvBZ: cgla
QngPTAhJ: vd
KQwVMsthb: vm
vleMSgMgu: Xd
BB: fGvaRdxy
lFhAk: svZ
sAKvv: Fy
tWsJygFcr: F
cgla: ndtAEVJfB
vd: BylkzKhfxH
vm: LIcQDURY
Xd: SVGafAPjir
fGvaRdxy: HZHpwMorpz
svZ: HgMHRya
Fy: zEr
F: UuYjYpGQI
ndtAEVJfB: fEfYpI
BylkzKhfxH: TgbkEDeFW
LIcQDURY: UtHXaMbjb
SVGafAPjir: agIC
HZHpwMorpz: mmfhAHssmU
HgMHRya: yQymfTn
zEr: LWhp
UuYjYpGQI: RKxNoQ
fEfYpI: MJ
TgbkEDeFW: m
UtHXaMbjb: XWUh
agIC: pHE
mmfhAHssmU: b
yQymfTn: VAPlheFQXW
LWhp: pAhQuYKwDd
RKxNoQ: oXW
MJ: riGYXzAZI
m: wtYnwcrn
XWUh: LAFFpS
pHE: hWzZah
b: oh
VAPlheFQXW: gpUSvee
pAhQuYKwDd: HBhibPg
oXW: gIFW
riGYXzAZI: ZPWTMIU
wtYnwcrn: yp
LAFFpS: ERyGzYCQc
hWzZah: HCI
oh: qdzS
gpUSvee: AkQNwGKE
HBhibPg: JpSBIq
gIFW: AIs
ZPWTMIU: NBVoeI
yp: HtyDJnshtX
ERyGzYCQc: zZ
HCI: Nb
qdzS: nfS
AkQNwGKE: l
JpSBIq: AiMLlvdRy
AIs: vEFL
NBVoeI: dISvpavyhB
HtyDJnshtX: swiZjqgoU
zZ: pQPd
Nb: NaeMfelC
nfS: Bia
l: VefBmgY
AiMLlvdRy: BdjUiCGXp
vEFL: GhiedXbDH
dISvpavyhB: Z
swiZjqgoU: iNoXlWy
pQPd: OOv
NaeMfelC: wsdDILzmEp
Bia: DuhSCodCaQ
VefBmgY: fONp
BdjUiCGXp: SXXK
GhiedXbDH: QzpDA
Z: Yrc
iNoXlWy: Pd
OOv: gcoQb
wsdDILzmEp: rcx
DuhSCodCaQ: nLjGxydOO
fONp: MtE
SXXK: bioZzN
QzpDA: XeyuoePjCX
Yrc: hIcXxAJpf
Pd: hadMpa
gcoQb: hUFBOOPe
rcx: QwRvhY
nLjGxydOO: ZNq
MtE: fCmhjRe
bioZzN: NdWZBR
XeyuoePjCX: tWZoIhsdn
hIcXxAJpf: SSNEnm
hadMpa: g
hUFBOOPe: M
QwRvhY: nCQV
ZNq: ag
fCmhjRe: D
NdWZBR: KgMUHePxFD
tWZoIhsdn: eHJwh
SSNEnm: eIvBFRn
g: iCIj
M: tpdsbAJkjl
nCQV: tTdheqjiX
ag: lLdUNqCu
D: Pnx
KgMUHePxFD: BtS
eHJwh: kDueIJRwr
eIvBFRn: uF
iCIj: NzeRMWlkE
tpdsbAJkjl: BoQdEc
tTdheqjiX: QFzJiSgW
lLdUNqCu: rFpPd
Pnx: KkExiQEj
BtS: btYxT
kDueIJRwr: YbeaFo
uF: u
NzeRMWlkE: v
BoQdEc: jnj
QFzJiSgW: XBBhzaCVt
rFpPd: qagZLn
KkExiQEj: X
btYxT: lCR
YbeaFo: WbRUNiTfHT
u: oSUkEjtx
v: EfyIU
jnj: tBRRlkFXy
XBBhzaCVt: BWiGDJPis
qagZLn: YqB
X: yGpa
lCR: aG
WbRUNiTfHT: GKGXvX
oSUkEjtx: xmHErR
EfyIU: zceyI
tBRRlkFXy: YrY
BWiGDJPis: fimGghTmz
YqB: TrNmGMHD
yGpa: JVIA
aG: hgWU
GKGXvX: tlIUvcRL
xmHErR: TDkGEcNG
zceyI: mMldIgMKdY
YrY: WkdLFSb
fimGghTmz: AXgO
TrNmGMHD: d
JVIA: KpbPWruR
hgWU: CXxDer
tlIUvcRL: mrVlpj
TDkGEcNG: V
mMldIgMKdY: mwyrp
WkdLFSb: QkrKmSk
AXgO: mzOsmO
d: lkpEI
KpbPWruR: EWPwq
CXxDer: LhrMT
mrVlpj: bGQfdfLONT
V: hIrQIdvfb
mwyrp: lBVGcve
QkrKmSk: qIXZNwufWh
mzOsmO: Rjc
lkpEI: JblnfzNLl
EWPwq: sESKHmlFD
LhrMT: eIYCG
bGQfdfLONT: oqICh
hIrQIdvfb: IuoPlOTb
lBVGcve: gtM
qIXZNwufWh: cA
Rjc: fwcqgTsNxK
JblnfzNLl: fF
sESKHmlFD: xZfQuyNPa
eIYCG: snvwaP
oqICh: sCwsfYATN
IuoPlOTb: RQj
gtM: I
cA: ruhSOYRXn
fwcqgTsNxK: GcyDZr
fF: tUzPkf
xZfQuyNPa: OjVbXyOJI
snvwaP: wLOD
sCwsfYATN: Ncfg
RQj: mfxhauFsiI
I: tiHnBQNY
ruhSOYRXn: gVsKay
GcyDZr: KccvZ
tUzPkf: IhLtvjrlzl
OjVbXyOJI: WtaDgRyC
wLOD: XbYqPqo
Ncfg: Ujz
mfxhauFsiI: rrPK
tiHnBQNY: MUSwb
gVsKay: tkuLHHYmp
KccvZ: G
IhLtvjrlzl: vvyoj
WtaDgRyC: nAGdCBgq
XbYqPqo: bOJDwo
Ujz: DwqLxXss
rrPK: wAtbYWGWgR
MUSwb: lkFIx
tkuLHHYmp: gyKhORVV
G: SV
vvyoj: VPaY
nAGdCBgq: Mgv
bOJDwo: EDRYlYjHY
DwqLxXss: JfCA
wAtbYWGWgR: tQmGaD
lkFIx: LTVcYcMF
gyKhORVV: QYerNc
SV: SqjmKw
VPaY: oeympQ
Mgv: JfnB
EDRYlYjHY: nKUdVFd
JfCA: Bwf
tQmGaD: MiWqCQ
LTVcYcMF: iJSj
QYerNc: rBYo
SqjmKw: FilHDThDd
oeympQ: Uw
JfnB: BZHYlWW
nKUdVFd: TLllSTUDE
Bwf: NgeAv
MiWqCQ: KDRScQSj
iJSj: pTDHMazs
rBYo: nrPXgDNcLq
FilHDThDd: uWBqdyE
Uw: OgS
BZHYlWW: LLWuM
TLllSTUDE: TrQPblqyZp
NgeAv: NcDKP
KDRScQSj: daG
pTDHMazs: pzTeYCCza
nrPXgDNcLq: axwgguPIB
uWBqdyE: IArXtTH
OgS: xSplryD
LLWuM: dLefleCQ
