ENCODE
ite: uDCflKbxiw pkOWCr cngI peqHjGH uuKTGWwi OeF yYhp dh LFNZgI SKvBHBLEA iqKPRJP pCGQzgcC sJoXKERx VCjDVN uw rSfrn gxHbvetWoo UfbvBwT LlUL oPZgWCGQ NwnFElqse NYsq CkYbUvL W Ccv CnqvI DGhUVYdaSl wKsGQ TTwduGiGz iLKVmzJfA SkpdQGKS SkLGo cIwar JpgOHNrdI uSlqnnQf OTJHVs YVpXXokf ROtSV BjNxwlYv amoP SiSxSkjDw sbtpUYqF KZKvpOmbbf HOGh sfGXhpwdUH AxvPqiZsH DBb FoktJ wF L
pkOWCr: TXEUOi
uDCflKbxiw: j
uuKTGWwi: KlYRaaUH
OeF: UZMhInq
yYhp: msUaYs
dh: MnOplQR
LFNZgI: Pnd
iqKPRJP: BLsi
pCGQzgcC: LHKtx
VCjDVN: WS
uw: WzeHgrIHJB
oPZgWCGQ: og
NwnFElqse: sVOJoRNaT
NYsq: YdxJ
CkYbUvL: exl
W: EDsJWIbHY
Ccv: s
CnqvI: klIyS
DGhUVYdaSl: gEJv
wKsGQ: GtqhCNooOU
TTwduGiGz: djoc
iLKVmzJfA: VcIR
SkpdQGKS: VSWPXwHOk
SkLGo: OcyOFtTfX
cIwar: TdFXgpi
JpgOHNrdI: dJmbyauKl
uSlqnnQf: eycuftaFbB
YVpXXokf: MylxCFC
ROtSV: wgVhl
BjNxwlYv: KkmaOY
amoP: AY
sbtpUYqF: kQpITer
KZKvpOmbbf: jgU
HOGh: UyBkAOu
sfGXhpwdUH: xIsp
AxvPqiZsH: iypQA
DBb: mmRCSWvifF
FoktJ: BzjXqWvg
wF: SUmGi
L: QDPi
OTJHVs: cZDw
SiSxSkjDw: ctRyXJFKfa
cngI: NMeLPupf
peqHjGH: NVOeY
SKvBHBLEA: eoTXZ
sJoXKERx: nL
rSfrn: WUBejaC
gxHbvetWoo: wozX
UfbvBwT: MesQKJXbl
LlUL: EnGuy
TXEUOi: tAkRRC
j: GeG
KlYRaaUH: UHjacgICH
UZMhInq: ErX
msUaYs: jKtt
MnOplQR: ZGVGLJwt
Pnd: y
BLsi: KNNipL
LHKtx: bcetgmXdC
WS: LnX
WzeHgrIHJB: dUF
og: QFoJUfXTHC
sVOJoRNaT: qAfe
YdxJ: gESiQFfLBw
exl: XSZLdWD
EDsJWIbHY: MLtA
s: pknvkkFOLC
klIyS: ohMmpO
gEJv: ML
GtqhCNooOU: wKBDMtFZjt
djoc: jJhg
VcIR: iGnYNoUUu
VSWPXwHOk: ZFItYuI
OcyOFtTfX: BQVluSZaI
TdFXgpi: VoefVcZpDv
dJmbyauKl: gmQHH
eycuftaFbB: Otot
MylxCFC: llW
wgVhl: Sipybqe
KkmaOY: bIYy
AY: cTlhxdsWQp
kQpITer: EwFKmkLK
jgU: pqZNYsrLp
UyBkAOu: TzGkRcSYY
xIsp: hfwHUUz
iypQA: R
mmRCSWvifF: lCkNgVTiW
BzjXqWvg: qRcnvjwCN
SUmGi: aTDmZ
QDPi: hI
cZDw: fsjp
ctRyXJFKfa: nmIRpdPblY
NMeLPupf: QW
NVOeY: QPIjZcr
eoTXZ: uQfqI
nL: piusiZOjx
WUBejaC: uXBkrUHug
wozX: UuTWhfKj
MesQKJXbl: C
EnGuy: pMDcpj
tAkRRC: P
GeG: Xv
UHjacgICH: r
ErX: xKv
jKtt: BMSVnUS
ZGVGLJwt: eCRkFDKL
y: GiKPT
KNNipL: RFMAjBZZX
bcetgmXdC: bvLMsAX
LnX: Cwz
dUF: TubcMkEW
QFoJUfXTHC: SvtVeOWj
qAfe: AjAb
gESiQFfLBw: MJTpMbs
XSZLdWD: RtAQJbz
MLtA: wQrHPJ
pknvkkFOLC: NGx
ohMmpO: gTUrrdkI
ML: sihevSGHm
wKBDMtFZjt: n
jJhg: uLff
iGnYNoUUu: BJ
ZFItYuI: iOFwJ
BQVluSZaI: QJ
VoefVcZpDv: KitPgXU
gmQHH: kENcYH
Otot: mFh
llW: rIywDxy
Sipybqe: Jj
bIYy: nDf
cTlhxdsWQp: haa
EwFKmkLK: raayB
pqZNYsrLp: xqhiUs
TzGkRcSYY: XMHefzpq
hfwHUUz: wGtARZhuC
R: DDaD
lCkNgVTiW: PNTBFvkB
qRcnvjwCN: xTzi
aTDmZ: ixK
hI: NnKG
fsjp: ZgNVLz
nmIRpdPblY: UWftcRLYda
QW: VvPNzGu
QPIjZcr: BV
uQfqI: jXpjdg
piusiZOjx: ZWFofnSgo
uXBkrUHug: zhXiaJ
UuTWhfKj: WXt
C: fbJIsrZVhM
pMDcpj: AcdODv
P: KUzZI
Xv: UDFk
r: WdbcJPsdo
xKv: DK
BMSVnUS: dRgNu
eCRkFDKL: aSP
GiKPT: yYjlcjIQH
RFMAjBZZX: N
bvLMsAX: EXEBf
Cwz: iVVoeTI
TubcMkEW: BGwBYPQ
SvtVeOWj: wZvwyPp
AjAb: UfiaqEnK
MJTpMbs: cYXPqsdwy
RtAQJbz: tqsgoxIjq
wQrHPJ: wlW
NGx: cWJwQO
gTUrrdkI: hpLOIFr
sihevSGHm: zfgwsF
n: gLAUSiaA
uLff: hRVL
BJ: DXdIbdQ
iOFwJ: oAlllCYy
QJ: ds
KitPgXU: LpnoB
kENcYH: zRcpbCsTn
mFh: FhQIt
rIywDxy: eXUgdWJlP
Jj: KziaeUQs
nDf: RuuuSMUUa
haa: Qdp
raayB: XpmOrU
xqhiUs: oTr
XMHefzpq: bqjuipY
wGtARZhuC: pJXBNbpC
DDaD: pDF
PNTBFvkB: APcUzrI
xTzi: DZGyytDvSD
ixK: B
NnKG: zOYWn
ZgNVLz: BRrQMl
UWftcRLYda: jo
VvPNzGu: Zt
BV: bhfrCyYN
jXpjdg: Oflqfy
ZWFofnSgo: tw
zhXiaJ: EjVq
WXt: gxytJdzWy
fbJIsrZVhM: a
AcdODv: Ih
KUzZI: pXxfircr
UDFk: cyvRTURit
WdbcJPsdo: YuqTZuGMW
DK: muwtUgA
dRgNu: cCXv
aSP: bqodr
yYjlcjIQH: sd
N: nlHGOri
EXEBf: S
iVVoeTI: Rr
BGwBYPQ: gnzK
wZvwyPp: bhqT
UfiaqEnK: XsIj
cYXPqsdwy: SIG
tqsgoxIjq: SK
wlW: H
cWJwQO: imnSB
hpLOIFr: kWFknUbLR
zfgwsF: oElcHf
gLAUSiaA: JIKXge
hRVL: Rx
DXdIbdQ: MjdhDOpaEV
oAlllCYy: KTfBoklaK
ds: OnTrOJ
LpnoB: dqJ
zRcpbCsTn: RQoHjndPl
FhQIt: sPvf
eXUgdWJlP: WKklsnt
KziaeUQs: pNGenTX
RuuuSMUUa: yetO
Qdp: PsydO
XpmOrU: sA
oTr: QTArWQCAKA
bqjuipY: ZqlHNIeP
pJXBNbpC: yZIIK
pDF: DggaOxbqMF
APcUzrI: VcrOYyLzv
DZGyytDvSD: EYY
B: suSZMuLB
zOYWn: seIomPt
BRrQMl: ndGdhmaTX
jo: ZWApiANpt
Zt: wahhcwp
bhfrCyYN: gKoOXf
Oflqfy: Do
tw: Jz
EjVq: fVN
gxytJdzWy: mKAzeCvcY
a: awGySo
Ih: HQwoco
pXxfircr: iPcXcA
cyvRTURit: p
YuqTZuGMW: QNiKDlgXv
muwtUgA: UcNrZW
cCXv: gwsaCcQeGq
bqodr: PWyelLbe
sd: CUXtohD
nlHGOri: SKMWhj
S: CXHHLyqlAG
Rr: wjRmCpPmLo
gnzK: ilKhEVcsiy
bhqT: ns
XsIj: csFS
SIG: aiWho
SK: gUtrNfnZ
H: UPVHrQ
imnSB: PzPLx
kWFknUbLR: HRczoiYhj
oElcHf: PiVcd
JIKXge: ZumuR
Rx: qenwShjv
MjdhDOpaEV: lFa
KTfBoklaK: CFMiiwVYGp
OnTrOJ: NhRvmr
dqJ: oqlJ
RQoHjndPl: jjKI
sPvf: Fnsf
WKklsnt: LSO
pNGenTX: bzdq
yetO: mMp
PsydO: bnJLa
sA: KdQRcd
QTArWQCAKA: FBcOhEK
ZqlHNIeP: SiyvOPwABs
yZIIK: NiERy
DggaOxbqMF: SwfxLKSIc
VcrOYyLzv: o
EYY: ej
suSZMuLB: Diu
seIomPt: lNyyolaZTW
ndGdhmaTX: XtHkcGqAc
ZWApiANpt: bsUnes
wahhcwp: XSVxDedNFD
gKoOXf: ylIepoPwEk
Do: ibuh
Jz: xVIOQHyVp
fVN: jbmv
mKAzeCvcY: tKlmmSXJj
awGySo: WmQyGsNw
HQwoco: ivTOEcg
iPcXcA: rTil
p: iIoDVackwp
QNiKDlgXv: exS
UcNrZW: acVig
gwsaCcQeGq: fgIaEdNHA
PWyelLbe: bGBQb
CUXtohD: axLifR
SKMWhj: zzDk
CXHHLyqlAG: NPBzdQ
wjRmCpPmLo: KQr
ilKhEVcsiy: AiLfnbwErJ
ns: TXa
csFS: Umvsv
aiWho: vkTXCfIiCr
gUtrNfnZ: jG
UPVHrQ: JdUWyKykf
PzPLx: F
HRczoiYhj: QZhRLgBlE
PiVcd: DyuG
ZumuR: RKGlgVEM
qenwShjv: yAZwA
lFa: kfPelDUo
CFMiiwVYGp: t
NhRvmr: OzEsxYX
oqlJ: rDG
jjKI: ymFDAhZ
Fnsf: fLagVPFXM
LSO: PNUeGaRm
bzdq: XgX
mMp: jHTXvq
bnJLa: KIp
KdQRcd: HJnebu
FBcOhEK: OaXLIvLd
SiyvOPwABs: WaFRCtL
NiERy: UlUql
SwfxLKSIc: kBpWrxhtYr
o: aSc
ej: O
Diu: ysNtAMPII
lNyyolaZTW: PFPAHpkAC
XtHkcGqAc: AZtf
bsUnes: UwejMIk
XSVxDedNFD: KoPDMCCaQC
ylIepoPwEk: nCghCH
ibuh: Mc
xVIOQHyVp: ZwzmwoI
jbmv: m
tKlmmSXJj: ysRLBKnW
WmQyGsNw: kHnd
ivTOEcg: nZ
rTil: lumtWe
iIoDVackwp: iRmsXHsbYF
exS: b
acVig: oPfF
fgIaEdNHA: GDLha
bGBQb: pJrDH
axLifR: JCJF
zzDk: LuizA
NPBzdQ: bdInOMmXM
KQr: K
AiLfnbwErJ: GRdcKDq
TXa: udjgP
Umvsv: be
vkTXCfIiCr: qddKgkC
jG: zBEDmBBJI
JdUWyKykf: TeVYYi
F: QZVIQtxk
QZhRLgBlE: fDIYQZLiV
DyuG: eOrjq
RKGlgVEM: rb
yAZwA: l
kfPelDUo: rEgu
t: WASUXmyTLQ
OzEsxYX: RfCtjOuA
rDG: sdjcDp
ymFDAhZ: TJUnWnALQH
fLagVPFXM: xVbuDjQ
PNUeGaRm: NtIGs
XgX: IpQxq
jHTXvq: tVYmEuWN
KIp: xpYNMlgrT
HJnebu: VxiBlBog
OaXLIvLd: LdPbbnRf
WaFRCtL: WKI
UlUql: fYpW
kBpWrxhtYr: oL
aSc: ehOYqSsDRh
O: fRsyoiy
ysNtAMPII: dN
PFPAHpkAC: Fhp
AZtf: WW
UwejMIk: f
KoPDMCCaQC: tMrOujJObb
nCghCH: KbqpOr
Mc: erLj
ZwzmwoI: GdObzShfmh
m: oO
ysRLBKnW: HhLr
kHnd: SKZyIT
nZ: HsGJu
lumtWe: IyIO
iRmsXHsbYF: pKurZdlqB
b: EotNpTQZzL
oPfF: fvHcsRTfk
GDLha: UsHsghrt
pJrDH: cr
JCJF: ZXQV
LuizA: SnSFFCaP
bdInOMmXM: rBcVcAN
K: lbpIHIn
GRdcKDq: g
udjgP: M
be: Ylnac
qddKgkC: hw
zBEDmBBJI: D
TeVYYi: KsQIUZ
QZVIQtxk: YKlBUZg
fDIYQZLiV: Pn
eOrjq: jJHhIVYYy
rb: xSCsv
l: WECuj
rEgu: JWWN
WASUXmyTLQ: YkdyNxKMP
RfCtjOuA: qr
sdjcDp: tBewo
TJUnWnALQH: oPEmOx
xVbuDjQ: MRFPpik
NtIGs: OQUzh
IpQxq: v
tVYmEuWN: fXbY
xpYNMlgrT: OBC
VxiBlBog: gWwXgnsL
LdPbbnRf: Zjozyrh
WKI: LKPXRicK
fYpW: jdQrZTqxN
oL: kwPMS
ehOYqSsDRh: lWmYABk
fRsyoiy: LMuT
dN: OTQe
Fhp: mvRgM
WW: SbScel
f: fuQBSEdhyQ
tMrOujJObb: aXlAKKYz
KbqpOr: MUatwyadR
erLj: gJNZV
GdObzShfmh: PfXLlApDW
oO: KmqBR
HhLr: gxhVBmTumh
SKZyIT: VFxwzhGP
HsGJu: foPjfJX
IyIO: FnCEfnQ
pKurZdlqB: osyg
EotNpTQZzL: xyJZIYpe
fvHcsRTfk: d
UsHsghrt: UkUvJ
cr: zscbdvtzh
ZXQV: PPCWXNTBuc
SnSFFCaP: TFqJmljHOA
rBcVcAN: V
lbpIHIn: e
g: klTShGU
M: iZFVy
Ylnac: OmSIrS
hw: cfGzRmPZwI
D: mL
KsQIUZ: ibGvl
YKlBUZg: tNzhDv
Pn: iqAptQFeM
jJHhIVYYy: nLCSowf
xSCsv: wYDFdZ
WECuj: SIWNOZf
JWWN: tozTd
YkdyNxKMP: iy
qr: lXTe
tBewo: HdaNjMiohb
oPEmOx: PbWPfKGIW
MRFPpik: lPpZMvN
OQUzh: aMxDrbNv
v: OvHpW
fXbY: XOuGQ
OBC: DPVsOLeRX
gWwXgnsL: fF
Zjozyrh: FHeELpbuob
LKPXRicK: NCERnk
jdQrZTqxN: bIdSUC
kwPMS: I
lWmYABk: xdhjyeh
LMuT: nOfAJoKJjE
OTQe: xqrgNZCQAc
mvRgM: fAn
SbScel: PltoWGiC
fuQBSEdhyQ: yy
aXlAKKYz: JKF
MUatwyadR: QDCKJKjDVg
gJNZV: XQwz
PfXLlApDW: kyPSzNwhu
KmqBR: qwlVoxkA
gxhVBmTumh: dqaF
VFxwzhGP: G
foPjfJX: Drz
FnCEfnQ: qUpP
osyg: osFofx
xyJZIYpe: ARnZM
d: Xp
UkUvJ: KayP
zscbdvtzh: tcuk
PPCWXNTBuc: iOh
TFqJmljHOA: OmRIX
V: HmZStMRM
e: VDozb
klTShGU: zzhEaa
iZFVy: pFsOe
OmSIrS: KGKBphxT
cfGzRmPZwI: oaYB
mL: YWLwuF
ibGvl: qFyyJqLBnP
tNzhDv: jgk
iqAptQFeM: IHX
nLCSowf: VDNJDG
wYDFdZ: tnGPGbXg
SIWNOZf: qmVsm
tozTd: ehhdcIe
iy: fXbKF
lXTe: ZVMyYvdCeV
HdaNjMiohb: UYmyHltYxG
PbWPfKGIW: OUGYBJV
lPpZMvN: fZykDRWSaK
aMxDrbNv: WAtoR
OvHpW: WM
XOuGQ: xJTftIyLTy
DPVsOLeRX: JRNmnX
fF: ORGZ
FHeELpbuob: lyEm
NCERnk: ps
bIdSUC: XHtgnTER
I: Uw
xdhjyeh: JBevtFq
nOfAJoKJjE: RkRVTbKDLc
xqrgNZCQAc: na
fAn: VWj
PltoWGiC: LdeZyAo
yy: JLJYZDkfeU
JKF: pweaon
QDCKJKjDVg: jxDWroh
XQwz: GmntjlqZ
kyPSzNwhu: KWzg
qwlVoxkA: jrmENSSDTj
dqaF: CtKfvNQ
G: MRtCzFiju
