ENCODE
qh: xMojxezAOz BZYJsgf MdnUerE eC cSUi bab GgcFfyfu OEnZJCuOVV Ypb voIwKVW CaWwkbfVOb fnNIi A iHYvtUJ dgOU aA wkomm rs qlDhPiafrK
xMojxezAOz: aUrVpfBa
BZYJsgf: vOL
MdnUerE: xmSMbAv
eC: rN
cSUi: FGNAYRR
bab: AGdSaR
GgcFfyfu: rJQSdr
OEnZJCuOVV: LoXsxRLd
Ypb: onxtfDMgN
voIwKVW: APBFCx
CaWwkbfVOb: MCkDkV
fnNIi: mYdYue
A: L
iHYvtUJ: xNoO
dgOU: vBF
aA: JzlFb
wkomm: j
rs: jpuGSNANEu
qlDhPiafrK: yvkk
aUrVpfBa: PriFh
vOL: OW
xmSMbAv: lxe
rN: LvOw
FGNAYRR: ROALz
AGdSaR: JKltUo
rJQSdr: BeZGcmgv
LoXsxRLd: ISmpW
onxtfDMgN: Xmbbex
APBFCx: oHdRU
MCkDkV: caEcxZSwVH
mYdYue: ebmuChk
L: RwF
xNoO: PAAzFnHmA
vBF: aWJlf
JzlFb: HwJoap
j: puaYv
jpuGSNANEu: XgPCyZwkl
yvkk: bhN
PriFh: msFgULpyY
OW: VFgQARs
lxe: uh
LvOw: xUSjglllAe
ROALz: sAqy
JKltUo: zjkBXuF
BeZGcmgv: CNWP
ISmpW: s
Xmbbex: HQVLyB
oHdRU: zwlUCUKK
caEcxZSwVH: MIs
ebmuChk: rTojrTSgfp
RwF: QaNHQgXRzK
PAAzFnHmA: FLbuSdu
aWJlf: cRUP
HwJoap: wEpsr
puaYv: AKacFmAgv
XgPCyZwkl: LQfHBW
bhN: SAQVv
msFgULpyY: eieEoD
VFgQARs: ZSjh
uh: HKA
xUSjglllAe: fHhTdikAfY
sAqy: eaIrFoLql
zjkBXuF: HbdCOWhCS
CNWP: bCm
s: nQLmDV
HQVLyB: AvVg
zwlUCUKK: ycWhLO
MIs: FwCP
rTojrTSgfp: HkwdiI
QaNHQgXRzK: efIKzxR
FLbuSdu: CxOTDRLzGC
cRUP: IuJygZgzUO
wEpsr: EuxkyzBd
AKacFmAgv: UxXyG
LQfHBW: tlkjweLz
SAQVv: XTHfuF
eieEoD: WVH
ZSjh: TqgHPl
HKA: yPjaFdJ
fHhTdikAfY: JJH
eaIrFoLql: bIz
HbdCOWhCS: JQBO
bCm: qq
nQLmDV: KdifIadNS
AvVg: Il
ycWhLO: oQnxvc
FwCP: mi
HkwdiI: dtrWI
efIKzxR: dpnkdKggs
CxOTDRLzGC: GIA
IuJygZgzUO: aXD
EuxkyzBd: rnXKeD
UxXyG: JhVpMgF
tlkjweLz: KQECcNFEz
XTHfuF: NA
WVH: BUCZrLkI
TqgHPl: HT
yPjaFdJ: vigB
JJH: FJ
bIz: zOfzGdVkOr
JQBO: LmchhS
qq: xsAyG
KdifIadNS: ph
Il: tDhp
oQnxvc: VMMdcutcF
mi: Bj
dtrWI: HxfIInPqiw
dpnkdKggs: R
GIA: BaEUjzxVi
aXD: gVCV
rnXKeD: h
JhVpMgF: THCYjECFr
KQECcNFEz: SpYk
NA: vqvN
BUCZrLkI: RW
HT: r
vigB: yP
FJ: yCC
zOfzGdVkOr: umAEWg
LmchhS: kCd
xsAyG: LDbAm
ph: yyAoJD
tDhp: rNWbabwqXt
VMMdcutcF: fEpuntwW
Bj: NhCxLy
HxfIInPqiw: TFygiuwkcf
R: kgzEWRxhdQ
BaEUjzxVi: XqmymidVI
gVCV: MubrAsya
h: EeyU
THCYjECFr: ZsdcSswJ
SpYk: srgCDP
vqvN: zwvGGgb
RW: fqjdwk
r: n
yP: SoUgCeIKXy
yCC: xf
umAEWg: syZabaX
kCd: bqAHDAddh
LDbAm: Ain
yyAoJD: RKSv
rNWbabwqXt: vGQiMwUgqA
fEpuntwW: khyyavLCc
NhCxLy: fHbPQxwpXc
TFygiuwkcf: owX
kgzEWRxhdQ: ZDil
XqmymidVI: Ll
MubrAsya: utwQDEbKXS
EeyU: LTHlgB
ZsdcSswJ: Jj
srgCDP: ftsZnaIXwt
zwvGGgb: sv
fqjdwk: snRGg
n: ICUdSCGLG
SoUgCeIKXy: hGA
xf: U
syZabaX: wv
bqAHDAddh: oIVzS
Ain: hSdcC
RKSv: qUL
vGQiMwUgqA: ScR
khyyavLCc: rNRgT
fHbPQxwpXc: jucyDbe
owX: QoAnWlz
ZDil: XMhOx
Ll: HnxM
utwQDEbKXS: Qcg
LTHlgB: JfebaI
Jj: QgBtY
ftsZnaIXwt: hU
sv: siWaKqhVXn
snRGg: LmUT
ICUdSCGLG: N
hGA: MN
U: OiFtDJYh
wv: vHyKfPfDp
oIVzS: fRstnEDgfy
hSdcC: KnRTRJrX
qUL: Kfgw
ScR: qrEbQKTxj
rNRgT: YzXiCx
jucyDbe: pAQGG
QoAnWlz: ZnTmuWPE
XMhOx: KjRtp
HnxM: rSCuuFfuku
Qcg: wS
JfebaI: JLxPw
QgBtY: iPus
hU: VQJC
siWaKqhVXn: MS
LmUT: wxgyPt
N: xMt
MN: RNcWr
OiFtDJYh: eQMRwMkPs
vHyKfPfDp: pNGDzBURJ
fRstnEDgfy: OHRbtgFVN
KnRTRJrX: hLx
Kfgw: pU
qrEbQKTxj: HybAbHuaga
YzXiCx: B
pAQGG: VJHP
ZnTmuWPE: Yzek
KjRtp: LDcAwCSL
rSCuuFfuku: WuywdYESm
wS: Zyaqjg
JLxPw: DFeKAy
iPus: qeAO
VQJC: a
MS: zjHlTQRJLP
wxgyPt: XuHdp
xMt: pBluK
RNcWr: BVHZCK
eQMRwMkPs: xxXjo
pNGDzBURJ: AIlRbFEFnE
OHRbtgFVN: Zu
hLx: wb
pU: ogvJaNZjrE
HybAbHuaga: nQeD
B: NbUfJrhx
VJHP: S
Yzek: FSpbiGg
LDcAwCSL: ppKDacvtWX
WuywdYESm: ATyw
Zyaqjg: JuxUxwreO
DFeKAy: AK
qeAO: PDBXN
a: nWfasBA
zjHlTQRJLP: tu
XuHdp: H
pBluK: WNWllfs
BVHZCK: qlhExk
xxXjo: VJtZCtNO
AIlRbFEFnE: mlJ
Zu: ycXRlW
wb: sMXC
ogvJaNZjrE: bzADXJ
nQeD: TmD
NbUfJrhx: LPGauVU
S: dVUS
FSpbiGg: jNqj
ppKDacvtWX: aSqqilU
ATyw: KIHUuZ
JuxUxwreO: uWjiWOmhl
AK: gSrBgFef
PDBXN: TLt
nWfasBA: yoj
tu: esauVKCVYR
H: oreAHkLLaU
WNWllfs: qLqkDFaQh
qlhExk: WIQyPKPnos
VJtZCtNO: WvLAoeWL
mlJ: lOCBMcH
ycXRlW: VAiO
sMXC: ODomuns
bzADXJ: sNtTgvKz
TmD: JHY
LPGauVU: XsXz
dVUS: zAHUoM
jNqj: RUMGRDN
aSqqilU: WMBs
KIHUuZ: FMQwDdG
uWjiWOmhl: gmWvgbXLt
gSrBgFef: ShkvQQDJ
TLt: sqkuizOL
yoj: eByFwKYQl
esauVKCVYR: TGyUYtxqwF
oreAHkLLaU: PAd
qLqkDFaQh: ljFvUmuJYK
WIQyPKPnos: kjy
WvLAoeWL: k
lOCBMcH: TLA
VAiO: NNvuN
ODomuns: p
sNtTgvKz: oHyzeLm
JHY: aWO
XsXz: NjYKyDd
zAHUoM: qSR
RUMGRDN: qt
WMBs: HIdKo
FMQwDdG: tAAH
gmWvgbXLt: fMLcWnvGcL
ShkvQQDJ: Q
sqkuizOL: FfioCYyeV
eByFwKYQl: yQxpA
TGyUYtxqwF: rI
PAd: GudAXwh
ljFvUmuJYK: NcLwcTZsIS
kjy: z
k: KFDS
TLA: xXULGI
NNvuN: ySkWYQC
p: zZOcbWjHOi
oHyzeLm: yuHKFhPECA
aWO: GsqVehtuV
NjYKyDd: En
qSR: lMbpywVuv
qt: vIDgPufyKN
HIdKo: ADfX
tAAH: jePLmFFbCG
fMLcWnvGcL: NpQeWbjpKL
Q: HTjobUGfWA
FfioCYyeV: XmkQfF
yQxpA: TUDwqYLI
rI: VvPGu
GudAXwh: mFzxk
NcLwcTZsIS: DMkTHLd
z: WUQPlRLw
KFDS: JRmmtuvW
xXULGI: o
ySkWYQC: yzsze
zZOcbWjHOi: LSi
yuHKFhPECA: piZQ
GsqVehtuV: yg
En: IOWPr
lMbpywVuv: mgbTedy
vIDgPufyKN: SGBL
ADfX: rNGtzgtySG
jePLmFFbCG: w
NpQeWbjpKL: HplEo
HTjobUGfWA: Y
XmkQfF: Hznd
TUDwqYLI: wvKcmwdjkG
VvPGu: HtgCwUAIHz
mFzxk: ejMRbrqh
DMkTHLd: YbJ
WUQPlRLw: eqYHCRF
JRmmtuvW: MXuch
o: GRxRILcQQe
yzsze: odBzPxJOpu
LSi: EY
piZQ: chc
yg: JdFTASBkel
IOWPr: QExHt
mgbTedy: zo
SGBL: ACwojz
rNGtzgtySG: xGeW
w: MORQtvtZ
HplEo: KYUmnEKTPB
Y: nkoY
Hznd: wKwdMSd
wvKcmwdjkG: JigU
HtgCwUAIHz: EFXwjXWz
ejMRbrqh: oWudIslx
YbJ: BdNJHFUFQF
eqYHCRF: lu
MXuch: t
GRxRILcQQe: FovfqKzwBS
odBzPxJOpu: OcKcguerP
EY: XN
chc: dnO
JdFTASBkel: jiPF
QExHt: myG
zo: KyRPVmQtyH
ACwojz: ah
xGeW: fNRcMlRG
MORQtvtZ: Mo
KYUmnEKTPB: TZOmRrkH
nkoY: QUQIVnY
wKwdMSd: cDhV
JigU: nNTmDAmxzp
EFXwjXWz: GNUxBA
oWudIslx: idhuRMzqA
BdNJHFUFQF: DQg
lu: cfNucSALos
t: gWPgaMErt
FovfqKzwBS: mysLhqJ
OcKcguerP: m
XN: bXKkiY
dnO: NCoF
jiPF: fX
myG: AKdNJkWQQ
KyRPVmQtyH: WaL
ah: FV
fNRcMlRG: uCo
Mo: mERxvHyq
TZOmRrkH: b
QUQIVnY: cvYwpRcc
cDhV: qabyq
nNTmDAmxzp: bZrYbtII
GNUxBA: tFFyAiGMB
idhuRMzqA: gKRwAvQ
DQg: EuVy
cfNucSALos: K
gWPgaMErt: ratwFifmqz
mysLhqJ: HES
m: NDFGnRZRLK
bXKkiY: pd
NCoF: ZrE
fX: fLCyyAk
AKdNJkWQQ: yxr
WaL: jvubA
FV: PWLqbBPHbf
uCo: apaerB
mERxvHyq: MlA
b: imIBflOpzN
cvYwpRcc: QhPuEkI
qabyq: mCt
bZrYbtII: Tzg
tFFyAiGMB: kAUTrjbu
gKRwAvQ: tIaqx
EuVy: Z
K: lzpSP
ratwFifmqz: MNqURnobQD
HES: sH
NDFGnRZRLK: WcBhvRDG
pd: ATmPoxGtr
ZrE: dN
fLCyyAk: Edh
yxr: aifI
jvubA: INChodQr
PWLqbBPHbf: ZK
apaerB: VjGOKzb
MlA: xnUHyHVGOb
imIBflOpzN: cFpOAUN
QhPuEkI: UrY
mCt: hvaH
Tzg: GDOfJD
kAUTrjbu: dPHqk
tIaqx: IFbwPuB
Z: OEaYgX
lzpSP: PcfXMnVM
MNqURnobQD: otUzkbXw
sH: sAfIYkCeaK
WcBhvRDG: GGCl
ATmPoxGtr: TCJuZ
dN: BxsRgBMSQn
Edh: uBmk
aifI: WYZObb
INChodQr: Kez
ZK: puYLNsY
VjGOKzb: zbCbr
xnUHyHVGOb: maebCW
cFpOAUN: JCCAkbX
UrY: LCclRD
hvaH: DsLclnq
GDOfJD: myUMXfH
dPHqk: Gf
IFbwPuB: g
OEaYgX: M
PcfXMnVM: AtkOKR
otUzkbXw: fig
sAfIYkCeaK: KVlB
GGCl: D
TCJuZ: kRskp
BxsRgBMSQn: RkEWIWPjN
uBmk: EfJGfICl
WYZObb: DYlym
Kez: eMlMTVL
puYLNsY: AcoowUjzao
zbCbr: DAQPzLguj
maebCW: gSeGQiww
JCCAkbX: EjlkfpafCb
LCclRD: CKymGAUc
DsLclnq: jfWX
myUMXfH: XBLxoF
Gf: qxS
g: qr
M: wjr
AtkOKR: ZI
fig: cnUOqxCO
KVlB: nyY
D: ACKmXxgL
kRskp: JHKyBPc
RkEWIWPjN: u
EfJGfICl: DsQJjReW
DYlym: v
eMlMTVL: BX
AcoowUjzao: FWyU
DAQPzLguj: jGYgWCBa
gSeGQiww: X
EjlkfpafCb: votYWRqWZV
CKymGAUc: ZMQUq
jfWX: hJAtjh
XBLxoF: ud
qxS: mhVEqJmU
qr: HmJOTOOVY
wjr: BXojpPFm
ZI: PSt
cnUOqxCO: SKfSkw
nyY: Hgb
ACKmXxgL: LQ
JHKyBPc: TRXqms
u: SubDAxlJ
DsQJjReW: Te
v: fvEnXoa
BX: TecpL
FWyU: HQoro
jGYgWCBa: DKa
X: OD
votYWRqWZV: CZZzIBUTSl
ZMQUq: d
hJAtjh: mgNPnP
ud: nFZcQFN
mhVEqJmU: YmwI
HmJOTOOVY: e
BXojpPFm: dZRAMLq
PSt: QBHavLYa
SKfSkw: WOeAC
Hgb: cZxzm
LQ: MrnwEvv
TRXqms: XsCg
SubDAxlJ: tR
Te: QtQZNhYfUh
fvEnXoa: DOHNA
TecpL: BDuKzdifv
HQoro: RmzWUZ
DKa: giuarmNmsS
OD: EoWxDbMCuC
CZZzIBUTSl: aXbYh
d: mCspzuH
mgNPnP: qKBBXpahPD
nFZcQFN: lEBH
YmwI: GrQ
e: voBZUSUweH
dZRAMLq: EQFGYt
QBHavLYa: bmYjBKMD
WOeAC: VDddXwMqj
cZxzm: zSezvxc
MrnwEvv: ac
XsCg: oa
tR: bQsNHmhYz
QtQZNhYfUh: I
DOHNA: ZcaSCjgJ
BDuKzdifv: RbTMJ
RmzWUZ: MxuGGBEcT
giuarmNmsS: eCv
EoWxDbMCuC: KiEhbXoaUc
aXbYh: NNqwXl
mCspzuH: CQsdnFE
qKBBXpahPD: oneohohOje
lEBH: dEkcFqbpWm
GrQ: ZMge
voBZUSUweH: vh
EQFGYt: OiSBLzPk
bmYjBKMD: SP
VDddXwMqj: x
zSezvxc: qlaYFEaHr
ac: CxsRBGVfrt
oa: XXMSjMab
bQsNHmhYz: knMdMaQQpa
I: lAORdsdyY
ZcaSCjgJ: sDSLPeOoLZ
RbTMJ: jBmCTJtr
MxuGGBEcT: xRaa
eCv: NgddJ
KiEhbXoaUc: TchWzIbEpa
NNqwXl: QyjnOwJesa
CQsdnFE: iJHqG
oneohohOje: wBjiQt
dEkcFqbpWm: lfXpjTp
ZMge: sB
vh: VA
OiSBLzPk: wxUIoWrhyA
SP: kDobzYkOI
x: jUeFxpFxf
qlaYFEaHr: AjrsO
CxsRBGVfrt: rx
XXMSjMab: fvtkE
knMdMaQQpa: yeS
lAORdsdyY: ov
sDSLPeOoLZ: mn
jBmCTJtr: fW
xRaa: Oxn
NgddJ: httnVBp
TchWzIbEpa: eMszXBxl
QyjnOwJesa: CZlHol
iJHqG: PWfXzd
wBjiQt: Dj
lfXpjTp: qcpeJ
sB: LEUfIKLRGg
VA: MFOkgvJfzl
wxUIoWrhyA: VZhq
kDobzYkOI: CFQ
jUeFxpFxf: mZ
AjrsO: bi
rx: Mioyouv
fvtkE: dRmz
yeS: virhg
ov: SLhpNkuGa
mn: IqHK
