ENCODE
nu: sR Dpk uvSTEOM
uvSTEOM: ovZD
sR: zhLFQgXS
Dpk: lNQ
ovZD: KSXQNBAosw
zhLFQgXS: HJTKztXom
lNQ: W
KSXQNBAosw: EfDIiAG
HJTKztXom: YEkmbPDr
W: fgZvSKTA
EfDIiAG: yTyPXOqk
YEkmbPDr: zYOjqcm
fgZvSKTA: mE
yTyPXOqk: uPEyKu
zYOjqcm: XSdCqQ
mE: YpcuxWPX
uPEyKu: hSIyAZnca
XSdCqQ: dwDWEAFbW
YpcuxWPX: wFxNbPuR
hSIyAZnca: vsjJJ
dwDWEAFbW: YQqYD
wFxNbPuR: aJCIzrXBm
vsjJJ: OHeYrI
YQqYD: GoMuIqspgY
aJCIzrXBm: svGDHElB
OHeYrI: sAYd
GoMuIqspgY: oByNrcmecr
svGDHElB: KbSRsqSaXQ
sAYd: bVTsTFLpbu
oByNrcmecr: TADBNNPh
KbSRsqSaXQ: Dyh
bVTsTFLpbu: jxZqO
TADBNNPh: ccljg
Dyh: nKjlS
jxZqO: gskWtTe
ccljg: vqLYSTIV
nKjlS: j
gskWtTe: TZl
vqLYSTIV: TXRXtOSkzT
j: q
TZl: ETAIQG
TXRXtOSkzT: LBNygvt
q: Bxc
ETAIQG: HZ
LBNygvt: TqQBojyxw
Bxc: dNBncUe
HZ: RZWf
TqQBojyxw: hPMNgdXulH
dNBncUe: MBfl
RZWf: LhKDoKrgq
hPMNgdXulH: Ym
MBfl: Oof
LhKDoKrgq: kvXgRUWdrw
Ym: s
Oof: IrISlv
kvXgRUWdrw: lvdYKIMU
s: E
IrISlv: GXJ
lvdYKIMU: SPyECiaeN
E: dNHOm
GXJ: AkpltGeDzV
SPyECiaeN: TCJwaF
dNHOm: Cztdzs
AkpltGeDzV: LhAxU
TCJwaF: FVFKbmnzP
Cztdzs: pt
LhAxU: aKJkA
FVFKbmnzP: FlFpiDHWu
pt: Wo
aKJkA: aRKnbelCb
FlFpiDHWu: lmjOZnABs
Wo: aCuEgjp
aRKnbelCb: xxdbLXC
lmjOZnABs: ISXCClUi
aCuEgjp: xYYaWeUW
xxdbLXC: ZUTSuqqgd
ISXCClUi: JJgoaAhlUi
xYYaWeUW: JSE
ZUTSuqqgd: TbIMl
JJgoaAhlUi: MARuJ
JSE: uxXcq
TbIMl: XvpkKIT
MARuJ: RJoPglRXFL
uxXcq: bd
XvpkKIT: fDSFjOPyV
RJoPglRXFL: ONEWVNDAm
bd: PiG
fDSFjOPyV: GrENNm
ONEWVNDAm: YcNVsX
PiG: KvROewbyi
GrENNm: SBgRYsyNPV
YcNVsX: mgpGH
KvROewbyi: y
SBgRYsyNPV: cMC
mgpGH: QrJPGVWylH
y: NZwzQYMub
cMC: jn
QrJPGVWylH: ZxADulCZ
NZwzQYMub: yO
jn: naJ
ZxADulCZ: LFoWxO
yO: cLCR
naJ: Lq
LFoWxO: VZXGzTRgW
cLCR: GH
Lq: iCKaDAZJfN
VZXGzTRgW: pMfxkP
GH: Bnv
iCKaDAZJfN: ncJnZa
pMfxkP: EArYQM
Bnv: FRAsxDyR
ncJnZa: PWxbiNUmjD
EArYQM: jufNtKY
FRAsxDyR: yRFhfaL
PWxbiNUmjD: aP
jufNtKY: QnJB
yRFhfaL: hCEsX
aP: NHQbZQ
QnJB: ghXYyyWOJ
hCEsX: sFz
NHQbZQ: AKoZAQcu
ghXYyyWOJ: kpy
sFz: dpoNkrAhnF
AKoZAQcu: nC
kpy: PDufTGY
dpoNkrAhnF: wkrvk
nC: YIVhdaYF
PDufTGY: vJslIYnPX
wkrvk: EEQ
YIVhdaYF: iWJQras
vJslIYnPX: aa
EEQ: XEbkxLo
iWJQras: dDvuH
aa: oLE
XEbkxLo: OjKsOhZ
dDvuH: qYPMp
oLE: IPYmd
OjKsOhZ: h
qYPMp: RLF
IPYmd: ncPXQVn
h: C
RLF: oYMbSHA
ncPXQVn: P
C: r
oYMbSHA: ZpviFQfMW
P: OEseeUX
r: rWknheR
ZpviFQfMW: jwS
OEseeUX: HGn
rWknheR: opXPVfDnc
jwS: HMKkHBtUif
HGn: zljkJfu
opXPVfDnc: SLF
HMKkHBtUif: DleL
zljkJfu: SoPwUVrA
SLF: rUkHa
DleL: RZIEuyaP
SoPwUVrA: MutJ
rUkHa: pvxr
RZIEuyaP: xdDDBeYCjI
MutJ: PzNZqg
pvxr: tZ
xdDDBeYCjI: tV
PzNZqg: Oo
tZ: zha
tV: rWmIYfoG
Oo: rnQNYRnaO
zha: Xx
rWmIYfoG: EQMKkQqjRj
rnQNYRnaO: QyPgxYTU
Xx: DfUVdoWi
EQMKkQqjRj: tc
QyPgxYTU: QOzAmcKhP
DfUVdoWi: EgadMzel
tc: yqodGZpo
QOzAmcKhP: XMsnYJm
EgadMzel: i
yqodGZpo: sY
XMsnYJm: OeXIB
i: ljow
sY: HQNxvEhZ
OeXIB: U
ljow: HVIor
HQNxvEhZ: UKr
U: koIprWmEF
HVIor: AsCJv
UKr: RULF
koIprWmEF: hoG
AsCJv: pOynRlseqj
RULF: Ck
hoG: zoRa
pOynRlseqj: sL
Ck: jrb
zoRa: dSejdovel
sL: tjtn
jrb: rY
dSejdovel: CwAhBu
tjtn: WVnoyQ
rY: holUevZdm
CwAhBu: xanQtDj
WVnoyQ: mIQWZ
holUevZdm: ES
xanQtDj: CvtTewF
mIQWZ: UZqVdYB
ES: HxqeKYwE
CvtTewF: Pgm
UZqVdYB: dQvbKGT
HxqeKYwE: RZ
Pgm: qoRXygHFMS
dQvbKGT: XCcXg
RZ: dWAp
qoRXygHFMS: ThLcMCTHJH
XCcXg: rOFvKKxzYJ
dWAp: Um
ThLcMCTHJH: qMXSExXd
rOFvKKxzYJ: sRdlQFKiZk
Um: aiWmnC
qMXSExXd: TRsqLSZSsY
sRdlQFKiZk: gpHQMVnvX
aiWmnC: FEoqgd
TRsqLSZSsY: aoOetN
gpHQMVnvX: uowOsCH
FEoqgd: DlqtGovsv
aoOetN: B
uowOsCH: CAZFC
DlqtGovsv: mlxMXs
B: lveTcX
CAZFC: YtybV
mlxMXs: jo
lveTcX: aABRk
YtybV: AixScfivb
jo: vsFnNgHJAy
aABRk: a
AixScfivb: RcFW
vsFnNgHJAy: tldchdAQHJ
a: Ilup
RcFW: xuV
tldchdAQHJ: AZBoRg
Ilup: wCtKXX
xuV: keLSwm
AZBoRg: eypY
wCtKXX: NM
keLSwm: nHpfjd
eypY: iDQZA
NM: CNneSOK
nHpfjd: imfyKgrY
iDQZA: JYKSqJNUJm
CNneSOK: dBwoa
imfyKgrY: GVY
JYKSqJNUJm: tu
dBwoa: H
GVY: mTSTh
tu: fK
H: RC
mTSTh: qiemDy
fK: AZBcO
RC: Ns
qiemDy: EwrGT
AZBcO: GweICJmR
Ns: dhpDv
EwrGT: oE
GweICJmR: MNhIGB
dhpDv: ouvQyHQEc
oE: pqaEDlcilg
MNhIGB: iIEKwPfkXB
ouvQyHQEc: vQsVN
pqaEDlcilg: AJviqFAFFB
iIEKwPfkXB: eNTS
vQsVN: OwDdmlfp
AJviqFAFFB: bH
eNTS: OboISWLM
OwDdmlfp: vc
bH: DMNwdD
OboISWLM: nrQMFlO
vc: EDfs
DMNwdD: HLlzQAhrEx
nrQMFlO: uvSySls
EDfs: HUVeadL
HLlzQAhrEx: WQRChEcbWf
uvSySls: wIClgBD
HUVeadL: dpzOeyGaP
WQRChEcbWf: OTrKC
wIClgBD: ijpo
dpzOeyGaP: ctk
OTrKC: HdnvRH
ijpo: VtJ
ctk: PpgdBIYjm
HdnvRH: BJgkHna
VtJ: bVISgfX
PpgdBIYjm: VVxjgH
BJgkHna: ZobzMrXn
bVISgfX: p
VVxjgH: zRThArjr
ZobzMrXn: NljxOdgvD
p: VTjDidYhsy
zRThArjr: UaiwA
NljxOdgvD: fVAk
VTjDidYhsy: wUn
UaiwA: cHVOA
fVAk: guMckbzp
wUn: QUrwswhvXj
cHVOA: HZPvX
guMckbzp: YiEptHhei
QUrwswhvXj: FGjF
HZPvX: rNOcpuL
YiEptHhei: LOBeY
FGjF: WCF
rNOcpuL: ujnf
LOBeY: Q
WCF: UycWASliIB
ujnf: qELJSJ
Q: z
UycWASliIB: BwMG
qELJSJ: BLJun
z: GYByrIT
BwMG: zgyUthhiK
BLJun: XVEPtG
GYByrIT: zK
zgyUthhiK: RdKlaJh
XVEPtG: oXlHxU
zK: AB
RdKlaJh: wH
oXlHxU: kHudxjcRX
AB: pqOJSr
wH: XC
kHudxjcRX: LKZRMvmXCc
pqOJSr: Tj
XC: SKJr
LKZRMvmXCc: kXP
Tj: ZCZJ
SKJr: jwbvJSa
kXP: zqeLFgX
ZCZJ: xiXSDEA
jwbvJSa: w
zqeLFgX: qLOwYqpBq
xiXSDEA: Y
w: azJVGDrwH
qLOwYqpBq: KQNhVpjFS
Y: agjVTCeEJw
azJVGDrwH: Nt
KQNhVpjFS: ujwjRpJ
agjVTCeEJw: THIkOHeE
Nt: HOST
ujwjRpJ: ceF
THIkOHeE: VaRl
HOST: zTC
ceF: mOhXTDZ
VaRl: WGONz
zTC: jG
mOhXTDZ: oXRJtcT
WGONz: bwu
jG: mgYKsh
oXRJtcT: pKPypatT
bwu: Uu
mgYKsh: EkeXE
pKPypatT: F
Uu: JQWToRz
EkeXE: spOlTBn
F: NTRbXOfCy
JQWToRz: zSRCuAOfb
spOlTBn: yjuHr
NTRbXOfCy: t
zSRCuAOfb: YqjYJC
yjuHr: dMDzP
t: efdCkBPICl
YqjYJC: HEgyNcfHN
dMDzP: O
efdCkBPICl: NwTk
HEgyNcfHN: puIj
O: Lu
NwTk: XBxUU
puIj: pYwTSzc
Lu: jZyGDf
XBxUU: aAImdXLWjZ
pYwTSzc: Hvnr
jZyGDf: kHujL
aAImdXLWjZ: aHHZqCpUdt
Hvnr: m
kHujL: zEngRh
aHHZqCpUdt: RCSaYxeEnE
m: oYXsY
zEngRh: KqR
RCSaYxeEnE: Xn
oYXsY: LFZlXk
KqR: TwVADO
Xn: VN
LFZlXk: b
TwVADO: pfxJCkkDZs
VN: wMJZfFRY
b: SwNEsxZRtU
pfxJCkkDZs: CRvtziUgG
wMJZfFRY: woVA
SwNEsxZRtU: YbNdv
CRvtziUgG: Rxl
woVA: K
YbNdv: rDsH
Rxl: oxnLh
K: Kevse
rDsH: kDnHYyamO
oxnLh: wFRkW
Kevse: GDWkUdtH
kDnHYyamO: RBhDAxJk
wFRkW: fYCIzw
GDWkUdtH: fNWnFvSPkN
RBhDAxJk: aBc
fYCIzw: aT
fNWnFvSPkN: tbpLVTqlyP
aBc: rITelCbAzD
aT: l
tbpLVTqlyP: wECOrXqMG
rITelCbAzD: jMt
l: BZt
wECOrXqMG: Dgvfw
jMt: OFhlULZA
BZt: bEPZeYLAdH
Dgvfw: eRVSrE
OFhlULZA: fchFZafEf
bEPZeYLAdH: Z
eRVSrE: JNc
fchFZafEf: WzKTrzXGyq
Z: zeLqHfFEl
JNc: qMdmxmtNGn
WzKTrzXGyq: Zd
zeLqHfFEl: XIlWbWyX
qMdmxmtNGn: KQgbzdLRVv
Zd: xBqqzPL
XIlWbWyX: OwJs
KQgbzdLRVv: pZLvBHD
xBqqzPL: RVoXcXQJH
OwJs: f
pZLvBHD: kXDWonY
RVoXcXQJH: WjAyHhdQBK
f: oRPlOiGM
kXDWonY: rkaxncXhNT
WjAyHhdQBK: ASnJMD
oRPlOiGM: Dyma
rkaxncXhNT: kwElaoPbep
ASnJMD: Qw
Dyma: PPFqAELAL
kwElaoPbep: fBbXEyuNNi
Qw: ZYjNEK
PPFqAELAL: GEDenok
fBbXEyuNNi: JUuk
ZYjNEK: jOWBBqJIv
GEDenok: An
JUuk: gkeue
jOWBBqJIv: zxz
An: rM
gkeue: Pb
zxz: nQS
rM: hZczbDPUW
Pb: NeUHr
nQS: obLmWw
hZczbDPUW: MxoSLYNR
NeUHr: CG
obLmWw: EJF
MxoSLYNR: g
CG: M
EJF: WI
g: hCxicCNtvK
M: AchdchdF
WI: xarQ
hCxicCNtvK: YxKcktb
AchdchdF: OSOhB
xarQ: iWIHpIOoPR
YxKcktb: TLhfXV
OSOhB: qOPeivfscA
iWIHpIOoPR: dBGXgr
TLhfXV: eCOuLoOyA
qOPeivfscA: YYuBNCF
dBGXgr: BPPhwubTE
eCOuLoOyA: IhQ
YYuBNCF: QLkUbi
BPPhwubTE: QJY
IhQ: fkCsjD
QLkUbi: fePH
QJY: u
fkCsjD: LwIdugrnQ
fePH: v
u: X
LwIdugrnQ: AUsnoRkJrE
v: qBljTjAEU
X: CKrIyu
AUsnoRkJrE: vWsGxqq
qBljTjAEU: VynfGgGi
CKrIyu: NZmdUh
vWsGxqq: rvVrqHNFTe
VynfGgGi: UeqCcl
NZmdUh: eIhk
rvVrqHNFTe: bQ
UeqCcl: JztRAIY
eIhk: Lj
bQ: d
JztRAIY: oaZd
Lj: glhTmCnV
d: V
oaZd: e
glhTmCnV: ZO
V: tEUWd
e: FAaxj
ZO: pF
tEUWd: YfhVbaj
FAaxj: qfvzoSIn
pF: IoijJHS
YfhVbaj: aUGwwfiVdF
qfvzoSIn: CuzyY
IoijJHS: gyY
aUGwwfiVdF: dYWLiTfWJ
CuzyY: c
gyY: jJXiOQX
dYWLiTfWJ: YwnCmlfO
c: LDWqBqhac
jJXiOQX: jqCKar
YwnCmlfO: vWSorDFu
LDWqBqhac: XQ
jqCKar: RNQRy
vWSorDFu: irDVTq
XQ: nlURBvx
RNQRy: AeKjHhk
irDVTq: JXJhiewrv
nlURBvx: pUDpSv
AeKjHhk: tkQVz
JXJhiewrv: KDpDcSyALN
pUDpSv: EGMxZDry
tkQVz: ucl
KDpDcSyALN: waDyCzDcE
EGMxZDry: I
ucl: yNTrjS
waDyCzDcE: XJtTLOEq
I: hbljxckukN
yNTrjS: lFpifOFVZS
XJtTLOEq: EJfcNfwPhS
hbljxckukN: hml
lFpifOFVZS: OuofiUVc
EJfcNfwPhS: nMUs
hml: RsGs
OuofiUVc: MNCaqciPqx
nMUs: XAow
RsGs: XL
MNCaqciPqx: KssKrBvcSs
XAow: RH
XL: ODXONnvb
KssKrBvcSs: zviex
RH: RwYVE
ODXONnvb: G
zviex: nSQHouLzQ
RwYVE: lfNSDUFzg
G: DhAfDcrS
nSQHouLzQ: DSWbVJRrn
lfNSDUFzg: AsOKrLoeE
DhAfDcrS: hhrWl
DSWbVJRrn: Im
AsOKrLoeE: aFy
hhrWl: GXiAdq
Im: huqwA
aFy: DEvbO
GXiAdq: KTIXvt
huqwA: PjQtyvqDWN
DEvbO: iAgDCXQsaU
KTIXvt: YNahdMAp
PjQtyvqDWN: SquqPr
iAgDCXQsaU: DOtMpiA
YNahdMAp: fbjKIg
SquqPr: HoOMWvbwE
DOtMpiA: ApFQmhCG
fbjKIg: meBizVJddY
HoOMWvbwE: JIRvRUje
ApFQmhCG: qfnU
meBizVJddY: kTjKpEChko
JIRvRUje: LxQJzDNDog
qfnU: ID
kTjKpEChko: dXs
LxQJzDNDog: KFQNB
ID: YW
dXs: PoMaQv
KFQNB: MFQj
YW: KiXJrIOk
PoMaQv: kdn
MFQj: Yn
KiXJrIOk: xfsdqqC
kdn: Kn
Yn: vyuGWnsSJ
xfsdqqC: JuAA
Kn: XyFTId
vyuGWnsSJ: UFUPS
JuAA: hB
XyFTId: TvScPrKtAy
UFUPS: uDnZXnhzvx
hB: xov
TvScPrKtAy: QLQJnnl
uDnZXnhzvx: dJlqZOD
xov: uSPj
QLQJnnl: OGUxuSbBgl
dJlqZOD: qXv
uSPj: oGNYR
OGUxuSbBgl: sfRZ
qXv: EMcmK
