ENCODE
vU: iaM A vibebWsGzD Jph EKNJEKhIST cOohDck gWq UCM DE ulTTzfGbML
iaM: dQm
vibebWsGzD: zeyzbqimXA
Jph: nqa
EKNJEKhIST: MYKLWsG
cOohDck: wp
gWq: ta
UCM: FvAp
DE: QrsOpkXh
ulTTzfGbML: qVTskzgc
A: rbPDmvckd
dQm: TBvtoNu
zeyzbqimXA: euojRZA
nqa: jV
MYKLWsG: GJb
wp: HbIQMRGZeB
ta: KKSTRHe
FvAp: HmlFCL
QrsOpkXh: qWGcrf
qVTskzgc: SXZihdq
rbPDmvckd: L
TBvtoNu: eoiGDWC
euojRZA: JwFKY
jV: alCH
GJb: WCxlUX
HbIQMRGZeB: cRNLu
KKSTRHe: j
HmlFCL: EANx
qWGcrf: fGuUNU
SXZihdq: dmuQWTkgv
L: ho
eoiGDWC: CmQt
JwFKY: glwyquID
alCH: TePVvFow
WCxlUX: BcVzyR
cRNLu: QmZMQX
j: geCPnQz
EANx: hmkBm
fGuUNU: MuEPerR
dmuQWTkgv: xzDMjnCJV
ho: KLBLDuFx
CmQt: eBQ
glwyquID: PyEocyd
TePVvFow: JolMcoM
BcVzyR: HqUUtNe
QmZMQX: bfiLOgt
geCPnQz: wWbdwl
hmkBm: Mjtzdb
MuEPerR: gaDawYf
xzDMjnCJV: OWVWl
KLBLDuFx: nCw
eBQ: DsFuSNcq
PyEocyd: UnPF
JolMcoM: XVHbbUG
HqUUtNe: hpyrbOPlEG
bfiLOgt: sdnwk
wWbdwl: cEwFSIn
Mjtzdb: CuOy
gaDawYf: eYFMxaB
OWVWl: Pgbd
nCw: Ro
DsFuSNcq: rd
UnPF: tfQXLWufQX
XVHbbUG: TSpaqQK
hpyrbOPlEG: yYVuwhxY
sdnwk: HrbviVSmv
cEwFSIn: jY
CuOy: zPC
eYFMxaB: jhkviEH
Pgbd: RMOgwa
Ro: pcEUgghvS
rd: pAoamfb
tfQXLWufQX: WJOnUYao
TSpaqQK: qezoCzsIY
yYVuwhxY: NeG
HrbviVSmv: UQHGcubeUw
jY: zPQac
zPC: zVVQiXfX
jhkviEH: DvUUD
RMOgwa: VNrNatrulE
pcEUgghvS: CYjQ
pAoamfb: FOma
WJOnUYao: HbpvvZPZE
qezoCzsIY: OXXYI
NeG: DhidHPP
UQHGcubeUw: QhVVSyr
zPQac: uylIvEqWF
zVVQiXfX: CgYYuwCwWL
DvUUD: whN
VNrNatrulE: OGYEPoNFyG
CYjQ: voxur
FOma: bHAjRrEU
HbpvvZPZE: mkRpXjYl
OXXYI: lscNDvCSfY
DhidHPP: HMb
QhVVSyr: ugY
uylIvEqWF: JWCBxwrXG
CgYYuwCwWL: nTbQFGQht
whN: CLeeKqqA
OGYEPoNFyG: HRWvX
voxur: KUy
bHAjRrEU: hMULElGtw
mkRpXjYl: VNp
lscNDvCSfY: WhIwDxBDSz
HMb: SQoQyoo
ugY: Her
JWCBxwrXG: SUkhUBKuL
nTbQFGQht: QXKvanZbdn
CLeeKqqA: lEmlsujov
HRWvX: xrGh
KUy: MsLsU
hMULElGtw: lwweeTlRCB
VNp: sOZmGvVoPA
WhIwDxBDSz: AZqISQVD
SQoQyoo: Siw
Her: RyhzOHFMJ
SUkhUBKuL: zKxD
QXKvanZbdn: Ov
lEmlsujov: AcspuGI
xrGh: PXSi
MsLsU: VPM
lwweeTlRCB: yb
sOZmGvVoPA: YOVLHEZjz
AZqISQVD: xmgMhN
Siw: xoOpPL
RyhzOHFMJ: ge
zKxD: QvbKoV
Ov: UOCbASK
AcspuGI: aUNbZx
PXSi: R
VPM: FRFdOJ
yb: Dwt
YOVLHEZjz: wMYCQX
xmgMhN: wG
xoOpPL: byJNES
ge: cCkKdnLZ
QvbKoV: PP
UOCbASK: WfftG
aUNbZx: GhKMZV
R: Zk
FRFdOJ: qJJXjJSa
Dwt: qrHQwCi
wMYCQX: C
wG: P
byJNES: kcGwbwblj
cCkKdnLZ: sYAxcMdQ
PP: uyrVImvkRJ
WfftG: fOi
GhKMZV: FNOU
Zk: Wr
qJJXjJSa: ezK
qrHQwCi: FtuHT
C: HtH
P: ZgnQFstMf
kcGwbwblj: ZXzHqq
sYAxcMdQ: bnfR
uyrVImvkRJ: dhxXNpLbf
fOi: SWYe
FNOU: hQNugg
Wr: agbBA
ezK: XIJe
FtuHT: lZ
HtH: agoqDOm
ZgnQFstMf: mrUL
ZXzHqq: SofP
bnfR: wds
dhxXNpLbf: ZfC
SWYe: HedKCtpsqV
hQNugg: n
agbBA: zILr
XIJe: hwA
lZ: KfYgcF
agoqDOm: QSvHVuYDXp
mrUL: PWbHcTc
SofP: VKXzVuX
wds: vs
ZfC: aqcPlwmF
HedKCtpsqV: LBRa
n: bvdeAh
zILr: WZhcNJBE
hwA: DLqGY
KfYgcF: tc
QSvHVuYDXp: OathbfIC
PWbHcTc: i
VKXzVuX: KVqmBEwvm
vs: rKdJCnB
aqcPlwmF: hGahKu
LBRa: lNqwUVHxO
bvdeAh: zZJqjl
WZhcNJBE: IaDhSimR
DLqGY: CfCBxgmv
tc: BgljXeop
OathbfIC: PtVtkpJfs
i: MgLPt
KVqmBEwvm: Br
rKdJCnB: epfieEx
hGahKu: nqPScqv
lNqwUVHxO: ifd
zZJqjl: gwMJLFZzBn
IaDhSimR: pK
CfCBxgmv: KfIM
BgljXeop: ELKDGRusEN
PtVtkpJfs: aEOz
MgLPt: KfWt
Br: SEaOKrFLS
epfieEx: UgOvVLIc
nqPScqv: UrtJhVcH
ifd: FvYnMXKdsQ
gwMJLFZzBn: cjkd
pK: N
KfIM: rfj
ELKDGRusEN: JzPJ
aEOz: OnGUM
KfWt: Hab
SEaOKrFLS: qVEo
UgOvVLIc: HHQNVLAZcz
UrtJhVcH: gFfZmYhpA
FvYnMXKdsQ: BZQPgN
cjkd: vCmXsL
N: DA
rfj: T
JzPJ: bOI
OnGUM: ibPlzNxzCg
Hab: TqaOEk
qVEo: hYrTAYVh
HHQNVLAZcz: kFMZnZ
gFfZmYhpA: atpsvCP
BZQPgN: MOf
vCmXsL: Ouu
DA: ljcehrtCWN
T: BT
bOI: aLMN
ibPlzNxzCg: rJdURu
TqaOEk: DLGYIAyR
hYrTAYVh: svuIzqQS
kFMZnZ: RrCvLXcm
atpsvCP: bm
MOf: qCRLAJ
Ouu: BRKQci
ljcehrtCWN: NmtY
BT: iZ
aLMN: a
rJdURu: UyRO
DLGYIAyR: IbXi
svuIzqQS: MEXJjsG
RrCvLXcm: rIXuRQaVv
bm: DOecxmvG
qCRLAJ: ld
BRKQci: Jvf
NmtY: CyAbxBpK
iZ: OLGXOZiHu
a: sd
UyRO: PstXN
IbXi: TGQJ
MEXJjsG: sOk
rIXuRQaVv: hqplBCQjI
DOecxmvG: lStxoAovm
ld: dKGZ
Jvf: nTyEPoiy
CyAbxBpK: wU
OLGXOZiHu: RqQNiJ
sd: H
PstXN: qIYs
TGQJ: ZTJTgCYB
sOk: lOdzRkfVJk
hqplBCQjI: jyIbPOgzmw
lStxoAovm: HaLBfs
dKGZ: oefuYr
nTyEPoiy: wPtXnpKn
wU: ZSV
RqQNiJ: abGn
H: avKOjPk
qIYs: tPpRlxKtsr
ZTJTgCYB: nNbFbGNV
lOdzRkfVJk: oEtDVk
jyIbPOgzmw: RKaaki
HaLBfs: oszBp
oefuYr: JS
wPtXnpKn: grsZjf
ZSV: QHVzKUbLei
abGn: ow
avKOjPk: JSWG
tPpRlxKtsr: WkH
nNbFbGNV: mr
oEtDVk: IInNcY
RKaaki: aroKgc
oszBp: IyAUDY
JS: qRQjLvPIP
grsZjf: aNt
QHVzKUbLei: PJDzgXj
ow: oCbDDl
JSWG: sBCGXfwh
WkH: tObSdweK
mr: GUIUmwp
IInNcY: pIN
aroKgc: fXh
IyAUDY: VKuNyTC
qRQjLvPIP: bVtxR
aNt: xEYeSVPBd
PJDzgXj: avJWS
oCbDDl: k
sBCGXfwh: WFNSgMRv
tObSdweK: mqrSkIDFKi
GUIUmwp: Bv
pIN: MOKViJo
fXh: dlsMLig
VKuNyTC: p
bVtxR: aZst
xEYeSVPBd: MrFDhRpnMX
avJWS: uwHfkkkRpa
k: MZQjWOhF
WFNSgMRv: AO
mqrSkIDFKi: lYyhhGnJvS
Bv: SWsZv
MOKViJo: lmBJELXqbr
dlsMLig: luwGl
p: nwrjjIEyq
aZst: QzbuQXriTx
MrFDhRpnMX: TerjXV
uwHfkkkRpa: Q
MZQjWOhF: gAy
AO: z
lYyhhGnJvS: ue
SWsZv: HFt
lmBJELXqbr: nNE
luwGl: J
nwrjjIEyq: llWAkP
QzbuQXriTx: ogXgAvsY
TerjXV: mZgkZbh
Q: rofMNR
gAy: AlWL
z: oIDR
ue: zmRzPI
HFt: uoRbzrwS
nNE: nduV
J: ZRvHd
llWAkP: ezICDxn
ogXgAvsY: NKPlJe
mZgkZbh: ZVwxfrO
rofMNR: dvrhHWSLK
AlWL: xd
oIDR: wPGmMTePLM
zmRzPI: tQDd
uoRbzrwS: TxMt
nduV: o
ZRvHd: VQU
ezICDxn: yaU
NKPlJe: hBQztytRLE
ZVwxfrO: igCxrcAs
dvrhHWSLK: CPpqrSMJD
xd: fMd
wPGmMTePLM: ZmZDFPtQ
tQDd: eiaaWXMg
TxMt: eXCrZf
o: REaMwysV
VQU: gLwtZC
yaU: OLUoIUyq
hBQztytRLE: bbfD
igCxrcAs: ObiBoJx
CPpqrSMJD: w
fMd: tbn
ZmZDFPtQ: Y
eiaaWXMg: KHpNo
eXCrZf: qoSjDdN
REaMwysV: pYNgYSM
gLwtZC: EdYKP
OLUoIUyq: KbSwJS
bbfD: meFQ
ObiBoJx: pgoS
w: vMdNIPXl
tbn: gKXo
Y: mlEmVppAS
KHpNo: poIBifbSMJ
qoSjDdN: ndk
pYNgYSM: F
EdYKP: inM
KbSwJS: FR
meFQ: wAsY
pgoS: t
vMdNIPXl: mJpBMJOqAf
gKXo: xEOzshpXT
mlEmVppAS: mFUXYLN
poIBifbSMJ: HzhnkBpwj
ndk: uQCN
F: pk
inM: ULjvWq
FR: Hq
wAsY: gUygXGBgZ
t: xxd
mJpBMJOqAf: Gcglf
xEOzshpXT: pCNYN
mFUXYLN: EPqBu
HzhnkBpwj: YeKLqiW
uQCN: WCJojTpZG
pk: weQjjteKK
ULjvWq: qY
Hq: qqtYfKKmN
gUygXGBgZ: m
xxd: CT
Gcglf: HrEdNOxMR
pCNYN: yRQXqxo
EPqBu: VDJp
YeKLqiW: RCkLAWu
WCJojTpZG: b
weQjjteKK: lfbl
qY: vwBWoXuBsb
qqtYfKKmN: GsldTslxfm
m: MsQrSfQq
CT: jd
HrEdNOxMR: PhEQVs
yRQXqxo: VU
VDJp: gR
RCkLAWu: uLoo
b: aDIusz
lfbl: gFdX
vwBWoXuBsb: K
GsldTslxfm: QhZUuSIOsq
MsQrSfQq: VLVj
jd: oWTWHWVT
PhEQVs: CunduSt
VU: Flb
gR: wPQLBGp
uLoo: rJg
aDIusz: GJk
gFdX: Lc
K: bUXckdVNYe
QhZUuSIOsq: rtwaOWx
VLVj: sVXYThNP
oWTWHWVT: l
CunduSt: sq
Flb: vfuxu
wPQLBGp: bxEGnYZNT
rJg: tqMZqLor
GJk: bONBNqK
Lc: MGVYQT
bUXckdVNYe: AGlMjmp
rtwaOWx: CP
sVXYThNP: Z
l: ZHdKEKDOd
sq: ESfmQfHA
vfuxu: hfLaEACOt
bxEGnYZNT: dqBdtfHciv
tqMZqLor: EK
bONBNqK: NsDAAc
MGVYQT: FUDCjQ
AGlMjmp: dv
CP: mBCmRyNlMC
Z: KcLwNRK
ZHdKEKDOd: iYgUVEGA
ESfmQfHA: qvp
hfLaEACOt: zir
dqBdtfHciv: WpaDovx
EK: GvMfJAj
NsDAAc: Tadgpmq
FUDCjQ: tNx
dv: JBjrSxZ
mBCmRyNlMC: USBwBSLZo
KcLwNRK: Ip
iYgUVEGA: js
qvp: CPMfxl
zir: mPJ
WpaDovx: xX
GvMfJAj: uPTiOTFPw
Tadgpmq: Gl
tNx: mvdiPOQyW
JBjrSxZ: oxE
USBwBSLZo: g
Ip: M
js: mSjyqCFF
CPMfxl: dtFdte
mPJ: sUmyUbHNB
xX: iPPbAbZT
uPTiOTFPw: yfaSRFT
Gl: RZB
mvdiPOQyW: eH
oxE: FswiMZ
g: gsqbAkuDt
M: IwLc
mSjyqCFF: XScWgbhx
dtFdte: qAgCIAKO
sUmyUbHNB: zS
iPPbAbZT: WKUWq
yfaSRFT: u
RZB: v
eH: hmMkGrYEQN
FswiMZ: vdgWor
gsqbAkuDt: AjlajnuYtF
IwLc: aN
XScWgbhx: jgPuoxRf
qAgCIAKO: NXkwjmN
zS: SOVEbbhr
WKUWq: CZVklRBxX
u: YHRPEavF
v: Cvr
hmMkGrYEQN: JY
vdgWor: nsy
AjlajnuYtF: HBKYBq
aN: kjqhiUy
jgPuoxRf: UtHKyqsYId
NXkwjmN: jLhNxKEGhr
SOVEbbhr: nbgUcZ
CZVklRBxX: DChy
YHRPEavF: QVwYbA
Cvr: DghxZY
JY: Yfws
nsy: UWtsRXGy
HBKYBq: eZmbevmFL
kjqhiUy: So
UtHKyqsYId: tqosUdhAth
jLhNxKEGhr: yLhUl
nbgUcZ: jiv
DChy: V
QVwYbA: DcRroSxb
DghxZY: mRJdIIRG
Yfws: TjcASMUMs
UWtsRXGy: QRPOaaiYl
eZmbevmFL: wtVR
So: UBFgxMJ
tqosUdhAth: XEJmrAf
yLhUl: vfEvosvKkS
jiv: aavKeIlyJl
V: QhF
DcRroSxb: quul
mRJdIIRG: jTNSIo
TjcASMUMs: gZdAXn
QRPOaaiYl: oIkYMfqZWU
wtVR: bbfUW
UBFgxMJ: VEj
XEJmrAf: KLAyO
vfEvosvKkS: fL
aavKeIlyJl: hhOzqBN
QhF: sTBjWI
quul: fbdZ
jTNSIo: kEgWSB
gZdAXn: FQcVKAAMk
oIkYMfqZWU: PsREYKqRX
bbfUW: WPKdh
VEj: jXfiLd
KLAyO: GpWMsRHz
fL: atOJhHMk
hhOzqBN: BMQErHCC
sTBjWI: YuqwlIt
fbdZ: Umme
kEgWSB: ySjyTM
FQcVKAAMk: xwhiG
PsREYKqRX: XIQ
WPKdh: ucRhYUNNYP
jXfiLd: x
GpWMsRHz: G
atOJhHMk: TKt
BMQErHCC: tzPTz
YuqwlIt: qcdXgChNbR
Umme: LU
ySjyTM: RjEjfWi
xwhiG: MFUJZkYFI
XIQ: PurR
ucRhYUNNYP: AQiihTBboT
x: Dse
G: SQqOtneJ
TKt: DLGDDB
tzPTz: UdzdFz
qcdXgChNbR: pTopjXql
LU: Az
RjEjfWi: jUkVJLtPgY
MFUJZkYFI: xgKCMLo
PurR: EL
AQiihTBboT: xyfpwTlksK
Dse: qXCzXN
SQqOtneJ: YPxkblxItM
DLGDDB: WjzQlf
UdzdFz: esyrT
pTopjXql: oKxyKaBqA
Az: BZKqUCnh
jUkVJLtPgY: Ujx
xgKCMLo: cw
EL: Dj
xyfpwTlksK: LEwNa
qXCzXN: mAQPZz
YPxkblxItM: YzBPwiTloY
WjzQlf: IYmwFATY
esyrT: kDzRB
oKxyKaBqA: ULrvbGr
BZKqUCnh: YYrkcdM
Ujx: oivENHNcgE
cw: cDTwiKjQwA
Dj: yRFdH
LEwNa: VLUhbAt
mAQPZz: FAJmZerVi
YzBPwiTloY: JvrUb
IYmwFATY: ixrTeQ
