ENCODE
boqaikD: tdLX jGkoDQSI lIMsgk DwxhE ueCGjQl
tdLX: ffNMqfS
jGkoDQSI: lnmmBcWG
lIMsgk: KNubTDn
DwxhE: aBfsOKb
ueCGjQl: cSL
ffNMqfS: hPTS
lnmmBcWG: PaaWZ
KNubTDn: A
aBfsOKb: zMiEM
cSL: jzocJlxZq
hPTS: ddDWK
PaaWZ: yVVVPOuOb
A: Pzer
zMiEM: YlWfWADra
jzocJlxZq: iXicRS
ddDWK: Cqavbdn
yVVVPOuOb: inzhEMplAL
Pzer: SpTAT
YlWfWADra: ixfwnSpVs
iXicRS: pb
Cqavbdn: tKbZntg
inzhEMplAL: uYVRqzhBXm
SpTAT: uvcvEWRKwa
ixfwnSpVs: xPLD
pb: FNkW
tKbZntg: HGmE
uYVRqzhBXm: uywNyqSv
uvcvEWRKwa: lmSRALN
xPLD: bh
FNkW: lyXzA
HGmE: KLMEzqBZBg
uywNyqSv: oLHXnNCm
lmSRALN: CaSEjk
bh: TMH
lyXzA: OjIDlsJLO
KLMEzqBZBg: Qs
oLHXnNCm: hZWhfre
CaSEjk: j
TMH: BN
OjIDlsJLO: kqnQQDTV
Qs: NzkeQv
hZWhfre: fChzo
j: pduDYjtaaZ
BN: CoKNWXWTZa
kqnQQDTV: QYqoP
NzkeQv: odfPCrAc
fChzo: AxSRNaRw
pduDYjtaaZ: q
CoKNWXWTZa: NZLe
QYqoP: zh
odfPCrAc: gjx
AxSRNaRw: ZcwXwQlttD
q: qrIxrwt
NZLe: GWYpyES
zh: yW
gjx: xNGRLC
ZcwXwQlttD: aYW
qrIxrwt: NFkbkFE
GWYpyES: NaMcP
yW: NzGO
xNGRLC: JDhKbLkQ
aYW: fpqJeI
NFkbkFE: LjHtGIQr
NaMcP: evh
NzGO: XeAmktv
JDhKbLkQ: GdDtNMFz
fpqJeI: JWci
LjHtGIQr: mw
evh: E
XeAmktv: IgkYZeIROX
GdDtNMFz: gDwdgE
JWci: fba
mw: frqQipJQa
E: DuaWalC
IgkYZeIROX: FTSxcL
gDwdgE: oAVGlRSYu
fba: Ctl
frqQipJQa: dbt
DuaWalC: LfH
FTSxcL: AINHhubS
oAVGlRSYu: VAVpPX
Ctl: KnUhayQpw
dbt: aCtug
LfH: NOjJKMVYhs
AINHhubS: bkYdAEm
VAVpPX: NTueWAUCQo
KnUhayQpw: HHiw
aCtug: JxCEuy
NOjJKMVYhs: uuLTMpOB
bkYdAEm: ObyKNIuLY
NTueWAUCQo: ijhj
HHiw: yrcGhFB
JxCEuy: QfBHM
uuLTMpOB: XfwyWVkTkE
ObyKNIuLY: HADLyYCvGC
ijhj: xJeg
yrcGhFB: REAjLj
QfBHM: kPE
XfwyWVkTkE: cX
HADLyYCvGC: RCCoR
xJeg: y
REAjLj: pnO
kPE: sV
cX: BDbE
RCCoR: HmExp
y: jCfOK
pnO: zjWzYezpSv
sV: LFfhHQn
BDbE: bneIGCNacA
HmExp: zRh
jCfOK: LNGxQ
zjWzYezpSv: wcod
LFfhHQn: hPdMb
bneIGCNacA: RSqOe
zRh: hY
LNGxQ: RgzGvrYs
wcod: fvrPockM
hPdMb: xKWCXGir
RSqOe: Ov
hY: RLSflylo
RgzGvrYs: NPaKu
fvrPockM: pEDBkstT
xKWCXGir: R
Ov: gHl
RLSflylo: QNnuYEkNK
NPaKu: oIq
pEDBkstT: kYUxxkaOr
R: RoAtfRsRM
gHl: OsL
QNnuYEkNK: IfkcFIpeB
oIq: KkQNFzcP
kYUxxkaOr: Mz
RoAtfRsRM: WiV
OsL: dt
IfkcFIpeB: MScsbO
KkQNFzcP: fLHfSPDw
Mz: h
WiV: C
dt: P
MScsbO: r
fLHfSPDw: WVMOPQpAR
h: TEfMcd
C: CNKEebYYiN
P: ptbaA
r: WHtQxWwDG
WVMOPQpAR: wrbgrhRVRA
TEfMcd: VeehVJSX
CNKEebYYiN: EOTrOPf
ptbaA: Mhs
WHtQxWwDG: YN
wrbgrhRVRA: wfGIiUHx
VeehVJSX: SQhb
EOTrOPf: n
Mhs: DczXzoLYu
YN: cDWvjN
wfGIiUHx: dQUHHNo
SQhb: GwyezvMooN
n: UyzoRUZq
DczXzoLYu: DoD
cDWvjN: FRBHfMfdlF
dQUHHNo: URBlArdAV
GwyezvMooN: CjNE
UyzoRUZq: ISoP
DoD: LRDe
FRBHfMfdlF: kaoN
URBlArdAV: vrSCMaLtQn
CjNE: ztMaC
ISoP: i
LRDe: BlfsP
kaoN: eKTjCw
vrSCMaLtQn: sv
ztMaC: tlGxEgPv
i: jjkcAE
BlfsP: zKXsbbE
eKTjCw: EIcRIn
sv: HBYpYMF
tlGxEgPv: URmbdtt
jjkcAE: U
zKXsbbE: wePjz
EIcRIn: FLFd
HBYpYMF: xuaflus
URmbdtt: jfe
U: RX
wePjz: REDcTTnL
FLFd: Xl
xuaflus: CLe
jfe: eLXfdfTinC
RX: hpQZyGd
REDcTTnL: awaArtjtFf
Xl: LZCKmkINV
CLe: BcMcccFM
eLXfdfTinC: RKrizWZy
hpQZyGd: wmHcQ
awaArtjtFf: CfOnZZiQg
LZCKmkINV: RjTmxKQI
BcMcccFM: usXcriT
RKrizWZy: osaFq
wmHcQ: hy
CfOnZZiQg: bdDpjzCr
RjTmxKQI: QfJb
usXcriT: NElkc
osaFq: vHls
hy: ONAHTU
bdDpjzCr: ZqAYDAP
QfJb: VJI
NElkc: oLHqyEqbd
vHls: ESDNpg
ONAHTU: IVlNwXIGbj
ZqAYDAP: wkjw
VJI: jryKyzK
oLHqyEqbd: OogFFWBLzR
ESDNpg: EfZ
IVlNwXIGbj: ssqEGG
wkjw: YMHSaiEk
jryKyzK: fqSda
OogFFWBLzR: jtnLwCNhP
EfZ: nlsbuOuF
ssqEGG: TbngLILY
YMHSaiEk: iHuok
fqSda: FfRWdYva
jtnLwCNhP: dYmIzG
nlsbuOuF: bMNhqYeF
TbngLILY: th
iHuok: twogYHD
FfRWdYva: TvQiSmj
dYmIzG: jYcImsX
bMNhqYeF: iDRqGmagK
th: a
twogYHD: zQ
TvQiSmj: Ih
jYcImsX: keDC
iDRqGmagK: khaGRSfgG
a: KmNrs
zQ: EFlthwhNx
Ih: JTWiFoWc
keDC: CWolZLgXAb
khaGRSfgG: cOfvZ
KmNrs: SUVTnpNE
EFlthwhNx: RQc
JTWiFoWc: wrSguTqj
CWolZLgXAb: Mledry
cOfvZ: TrvOrEip
SUVTnpNE: CA
RQc: juqhvO
wrSguTqj: LILJPY
Mledry: acQnUUDb
TrvOrEip: NLjIR
CA: ZukV
juqhvO: JPip
LILJPY: vMl
acQnUUDb: FS
NLjIR: ieOLFuBc
ZukV: gfqjbBPwt
JPip: YVA
vMl: WEMrvzZqoL
FS: eDKhi
ieOLFuBc: tzRffJ
gfqjbBPwt: yBlE
YVA: qYW
WEMrvzZqoL: H
eDKhi: xuTW
tzRffJ: wMMxlpMPVS
yBlE: qxuTB
qYW: Unl
H: SBhbz
xuTW: ajfbDWNfss
wMMxlpMPVS: aUm
qxuTB: YrcQDaZp
Unl: olUeuTCAhj
SBhbz: ieIRBgQeIT
ajfbDWNfss: bipX
aUm: PRdJu
YrcQDaZp: Jifdrfy
olUeuTCAhj: lthJVsQ
ieIRBgQeIT: uU
bipX: vuk
PRdJu: LPpIUd
Jifdrfy: li
lthJVsQ: bSejOim
uU: AcHAe
vuk: ezVlKkZbat
LPpIUd: urg
li: gnQWpmKle
bSejOim: zwwphxUsBt
AcHAe: HnWZY
ezVlKkZbat: oUUSk
urg: aOVMOKTEwx
gnQWpmKle: mxmGIxkyM
zwwphxUsBt: NgDi
HnWZY: LRBBCYA
oUUSk: tcroF
aOVMOKTEwx: p
mxmGIxkyM: ONgX
NgDi: XjUQmhlAW
LRBBCYA: aFWsBQXvF
tcroF: gupTxMdCh
p: DtcRkdS
ONgX: MrmXHsfJp
XjUQmhlAW: qISUHkrVWS
aFWsBQXvF: LAuIjAAex
gupTxMdCh: ByAxod
DtcRkdS: uVWiP
MrmXHsfJp: nkGssAZuZ
qISUHkrVWS: tnv
LAuIjAAex: SiTOYBiokS
ByAxod: ktk
uVWiP: NbReiUSSR
nkGssAZuZ: ZU
tnv: BUSQYZwjiM
SiTOYBiokS: AtzbBicGI
ktk: J
NbReiUSSR: wsSHK
ZU: KmNrsFFBt
BUSQYZwjiM: Dq
AtzbBicGI: yzDTyQvvC
J: mMkLVOP
wsSHK: wV
KmNrsFFBt: DaPMiAzim
Dq: wzdVGp
yzDTyQvvC: RtniQ
mMkLVOP: KLVGv
wV: sEsP
DaPMiAzim: nFD
wzdVGp: RkaEjUrx
RtniQ: bjlbPGYYna
KLVGv: AFYgqu
sEsP: o
nFD: Ha
RkaEjUrx: IsqnKdeH
bjlbPGYYna: IdYQbnEQj
AFYgqu: RIVTPT
o: nbbpQb
Ha: FpzDz
IsqnKdeH: zGjLSSKfkt
IdYQbnEQj: PdJ
RIVTPT: ojlkfDi
nbbpQb: BEzK
FpzDz: jNmgxaTP
zGjLSSKfkt: pYxZ
PdJ: nyDkCfoc
ojlkfDi: MTZnJGza
BEzK: EQMoA
jNmgxaTP: w
pYxZ: MM
nyDkCfoc: yqPyG
MTZnJGza: ziUDcq
EQMoA: MPmo
w: KZK
MM: qpfDZjKAFU
yqPyG: FILgVU
ziUDcq: kkmaCkys
MPmo: fYbXvjetB
KZK: ysBm
qpfDZjKAFU: WgwFcQ
FILgVU: QEwVu
kkmaCkys: hUh
fYbXvjetB: xliN
ysBm: kKWHU
WgwFcQ: ZQWFDscczP
QEwVu: jG
hUh: HFnq
xliN: F
kKWHU: vrJWY
ZQWFDscczP: t
jG: dJokDQdeKN
HFnq: tHmYLsFO
F: qHBMEHLTaE
vrJWY: uZNFX
t: gnvcWN
dJokDQdeKN: rhGjwustdE
tHmYLsFO: STjx
qHBMEHLTaE: kxjffBJh
uZNFX: DG
gnvcWN: Mo
rhGjwustdE: EAqokj
STjx: ZquPWIvaW
kxjffBJh: xLu
DG: ksAUa
Mo: tYfU
EAqokj: m
ZquPWIvaW: dGNvwkASGy
xLu: Lpu
ksAUa: IeBLcWj
tYfU: uozrOgW
m: avM
dGNvwkASGy: fikUkvFnSd
Lpu: zTmVidN
IeBLcWj: EBxNPMC
uozrOgW: eeTJe
avM: oTxhKco
fikUkvFnSd: RukiRFZXd
zTmVidN: VBDyJSUSAe
EBxNPMC: TVDktmSM
eeTJe: rzVHH
oTxhKco: StaRHpA
RukiRFZXd: ZhPk
VBDyJSUSAe: be
TVDktmSM: fUmEzYI
rzVHH: sfpz
StaRHpA: ZQeCCT
ZhPk: eu
be: fpNaURI
fUmEzYI: VpLoV
sfpz: HmZeJKPC
ZQeCCT: yCBsx
eu: hDBuH
fpNaURI: we
VpLoV: TN
HmZeJKPC: CFEzXuB
yCBsx: uTPkCZMdzL
hDBuH: aw
we: l
TN: XPVfSRNp
CFEzXuB: FG
uTPkCZMdzL: fIGuCmYMt
aw: xojGST
l: MeAEtogJkg
XPVfSRNp: YLnWICK
FG: jQaqNC
fIGuCmYMt: uhGGsWve
xojGST: dQrV
MeAEtogJkg: Ynva
YLnWICK: Z
jQaqNC: iMjo
uhGGsWve: sH
dQrV: PNjA
Ynva: VjMkHf
Z: aXPu
iMjo: cVD
sH: VqRsQ
PNjA: ZHbPTYnOXi
VjMkHf: fm
aXPu: DYcrah
cVD: pV
VqRsQ: NgQU
ZHbPTYnOXi: TaGDTM
fm: YrBGPW
DYcrah: WbSayhOtx
pV: errXZ
NgQU: xHWenNoeP
TaGDTM: UqV
YrBGPW: NItkyO
WbSayhOtx: mC
errXZ: MNrfWmT
xHWenNoeP: DILdXGN
UqV: Uxa
NItkyO: EsEz
mC: UMCJm
MNrfWmT: ujdtZIxKJ
DILdXGN: JzuNhCqro
Uxa: WkHUOwQsS
EsEz: lca
UMCJm: js
ujdtZIxKJ: NrzKGlSeu
JzuNhCqro: cwPbzusg
WkHUOwQsS: sdXIozOh
lca: TOD
js: SPAiRszo
NrzKGlSeu: xoE
cwPbzusg: mySEWDbJLX
sdXIozOh: g
TOD: QyYQmMMxh
SPAiRszo: etYCFNyedC
xoE: TpPMQQqGCY
mySEWDbJLX: MPvo
g: bzeHSDHe
QyYQmMMxh: kyr
etYCFNyedC: vwzfbp
TpPMQQqGCY: oEkqfo
MPvo: AqfXQked
bzeHSDHe: CgUyBb
kyr: owG
vwzfbp: pw
oEkqfo: SITZVapw
AqfXQked: HZMfJZHKk
CgUyBb: FQGXEakJ
owG: lyGxqj
pw: gsutFDo
SITZVapw: Vpl
HZMfJZHKk: TjGryUp
FQGXEakJ: gNu
lyGxqj: tI
gsutFDo: u
Vpl: bWS
TjGryUp: v
gNu: yMXPKBy
tI: CtmWzue
u: X
bWS: THEwp
v: lyRUmwK
yMXPKBy: qAXK
CtmWzue: YADw
X: jUmdYY
THEwp: kyV
lyRUmwK: nnGH
qAXK: NkSfytaY
YADw: cZzxffc
jUmdYY: d
kyV: ywMu
nnGH: LUTSHeyUD
NkSfytaY: qf
cZzxffc: V
d: daf
ywMu: e
LUTSHeyUD: fv
qf: ScsOppD
V: DCxHv
daf: qsKRri
e: VI
fv: WqQIC
ScsOppD: STbcJ
DCxHv: c
qsKRri: iGt
VI: VHSSkhuyXs
WqQIC: CXvKV
STbcJ: cEQ
c: HsYZGI
iGt: APvhZ
VHSSkhuyXs: pLWSIjJvc
CXvKV: rLLUJr
cEQ: UahVWP
HsYZGI: I
APvhZ: BnTecI
pLWSIjJvc: rGpvD
rLLUJr: GGK
UahVWP: ppm
I: JtwkT
BnTecI: AHRUtPdDqF
rGpvD: Kuq
GGK: uhOkuWn
ppm: xnRxtrhTsO
JtwkT: aLLlBgzvV
AHRUtPdDqF: WgLN
Kuq: Svd
uhOkuWn: KbAT
xnRxtrhTsO: sw
aLLlBgzvV: xNOAM
WgLN: DtqjVdM
Svd: yMiQb
KbAT: TxZIa
sw: kdxUADO
xNOAM: G
DtqjVdM: hhmMf
yMiQb: eSU
TxZIa: YzWci
kdxUADO: YvQhYia
G: MOxfyfZs
hhmMf: YHfGDdf
eSU: SmXd
YzWci: nyVvQiZR
YvQhYia: Gj
MOxfyfZs: LdSCtj
YHfGDdf: CMDXVFhi
SmXd: kULgB
nyVvQiZR: QnAwmeppOZ
Gj: klAiJPkUV
LdSCtj: hbIBcLbe
CMDXVFhi: vSGpUf
kULgB: mQSgDcYSj
QnAwmeppOZ: msnrvR
klAiJPkUV: ypRamlVXb
hbIBcLbe: uSMmYO
vSGpUf: atyBhGFSf
mQSgDcYSj: uGwO
msnrvR: TmSegiolWn
ypRamlVXb: aV
uSMmYO: nsXLpIUwyN
atyBhGFSf: PREC
uGwO: ukv
TmSegiolWn: ZZzhnv
aV: DzqDmGPyD
nsXLpIUwyN: CZRbMABh
PREC: gtdcfBXJlh
ukv: FFtEO
ZZzhnv: lVIIhAC
DzqDmGPyD: nZKNQT
CZRbMABh: cpRyRW
gtdcfBXJlh: KRWnOD
FFtEO: BDspkOBbON
lVIIhAC: DVKyLTZoV
nZKNQT: iKOo
cpRyRW: UrtWIl
KRWnOD: frGHBRYZ
BDspkOBbON: gq
DVKyLTZoV: ROAdBkqyaO
iKOo: ffOliSKE
UrtWIl: cQ
frGHBRYZ: OVa
gq: XXNJCPQPUH
ROAdBkqyaO: vfaGiChz
ffOliSKE: tDQAyf
cQ: hGiUZE
OVa: SXYj
XXNJCPQPUH: RUbDwy
