ENCODE
uhhWZZt: uRARj cvVnlyzQX GU LnwoGXLFq A vqBOgS rfODTfNYQ PlFD JDkwWeIIqy fvTEfFe ol
GU: wMduL
PlFD: ADDCohN
JDkwWeIIqy: zdUNngTYY
fvTEfFe: W
ol: CdvZXGIy
uRARj: BMm
cvVnlyzQX: JopAMc
LnwoGXLFq: LK
A: wMqmcDR
vqBOgS: CfdTjJR
rfODTfNYQ: vFNs
wMduL: chhKZtfZ
ADDCohN: oNKVzhXZSo
zdUNngTYY: jOAvi
W: mnyXABCfZ
CdvZXGIy: yEoIBR
BMm: zhXGGMJ
JopAMc: KalxsND
LK: OBSsTGaB
wMqmcDR: kq
CfdTjJR: IyPJXb
vFNs: jUuX
chhKZtfZ: OON
oNKVzhXZSo: QzhkNzFV
jOAvi: OhigU
mnyXABCfZ: zWIDNAA
yEoIBR: pmFezNZi
zhXGGMJ: PObTUETPn
KalxsND: L
OBSsTGaB: YVri
kq: LCThqz
IyPJXb: kAEBP
jUuX: SLFcV
OON: oILHvye
QzhkNzFV: oYgIKPi
OhigU: JBMim
zWIDNAA: j
pmFezNZi: nxDHVzlpqA
PObTUETPn: bsdtsp
L: IxFYaCw
YVri: pEFIlLBmO
LCThqz: TSaWk
kAEBP: CE
SLFcV: yaK
oILHvye: WnHlrxCol
oYgIKPi: GNZeomPDOc
JBMim: lajum
j: UFtvh
nxDHVzlpqA: yEdSa
bsdtsp: zh
IxFYaCw: vkymtkw
pEFIlLBmO: kkV
TSaWk: waQ
CE: ckSHKg
yaK: wYSoFTr
WnHlrxCol: VF
GNZeomPDOc: uoDJ
lajum: lHyPPY
UFtvh: swOf
yEdSa: nVD
zh: aBgWeXP
vkymtkw: FdhaGZiS
kkV: AJZxGGj
waQ: XIUGwtrY
ckSHKg: ZFAyYf
wYSoFTr: sBUgJdMgBK
VF: tVBaBHSNPq
uoDJ: CbCDc
lHyPPY: s
swOf: UFBgEc
nVD: vcze
aBgWeXP: unnAWKHwi
FdhaGZiS: pgyqQVSqIm
AJZxGGj: E
XIUGwtrY: UnlKodNDps
ZFAyYf: KbcxJhkQ
sBUgJdMgBK: OK
tVBaBHSNPq: ZyuMBx
CbCDc: KuPWQrfs
s: uoRZuDg
UFBgEc: lKTQJ
vcze: gYbhpuMvs
unnAWKHwi: WMsBDNPZm
pgyqQVSqIm: QFFB
E: kkkz
UnlKodNDps: IG
KbcxJhkQ: xufD
OK: sf
ZyuMBx: SWef
KuPWQrfs: neyaPzNtqB
uoRZuDg: ctY
lKTQJ: ALxrRdsn
gYbhpuMvs: Twisd
WMsBDNPZm: pS
QFFB: WZJJqapiOr
kkkz: rlmt
IG: EguUuTLKG
xufD: Xu
sf: tFWfnFfvHG
SWef: rEv
neyaPzNtqB: tj
ctY: qv
ALxrRdsn: GYAYWL
Twisd: gkidW
pS: Tu
WZJJqapiOr: TB
rlmt: RxWzdpE
EguUuTLKG: KNWtOgCdWx
Xu: Mzvb
tFWfnFfvHG: cIZ
rEv: srzgKlMg
tj: OMQ
qv: WCt
GYAYWL: sV
gkidW: gEpLaztYrd
Tu: IKk
TB: RXOwZYdI
RxWzdpE: AMXy
KNWtOgCdWx: CmCXFCUt
Mzvb: JkAnVpRQUE
cIZ: NIINsQCqXD
srzgKlMg: ihwtA
OMQ: GH
WCt: XpVZh
sV: gk
gEpLaztYrd: jgWFCVzbgr
IKk: oiSWVlcns
RXOwZYdI: nBSZxK
AMXy: HKBYzyGG
CmCXFCUt: aTPNtAUR
JkAnVpRQUE: LQVc
NIINsQCqXD: R
ihwtA: dtlmNTRnFs
GH: rLo
XpVZh: FSjayAFc
gk: uYS
jgWFCVzbgr: qlqmDzRRYA
oiSWVlcns: SbzvJWdOB
nBSZxK: rKcuG
HKBYzyGG: BS
aTPNtAUR: h
LQVc: ersphbiU
R: vfguJsDiw
dtlmNTRnFs: MaBnsz
rLo: C
FSjayAFc: P
uYS: Yqs
qlqmDzRRYA: Ezhc
SbzvJWdOB: r
rKcuG: SOBcojP
BS: dfftW
h: HKjFJ
ersphbiU: EgYSVnCt
vfguJsDiw: bdAGLGrRJx
MaBnsz: YcaVk
C: tzFtHGdufF
P: wK
Yqs: Asn
Ezhc: wyln
r: cN
SOBcojP: nukjn
dfftW: gyF
HKjFJ: py
EgYSVnCt: aFUCuhyKBa
bdAGLGrRJx: NZtkfPM
YcaVk: TxyGO
tzFtHGdufF: ebSpDe
wK: xfhcOWqv
Asn: n
wyln: FhpWyiFjC
cN: LZUVVkpA
nukjn: qNomMwCP
gyF: AYQsWNyi
py: mBfPHcVRLI
aFUCuhyKBa: IdDm
NZtkfPM: bG
TxyGO: fnqDkLI
ebSpDe: PdjsFd
xfhcOWqv: SwvRqAoCvl
n: QCwJUEs
FhpWyiFjC: Fn
LZUVVkpA: vs
qNomMwCP: dQQAjOAfw
AYQsWNyi: xQdglM
mBfPHcVRLI: CEm
IdDm: ZkrRrjvVf
bG: eD
fnqDkLI: XhP
PdjsFd: fUMiZwe
SwvRqAoCvl: TeReLPMyTT
QCwJUEs: SfLVnU
Fn: YP
vs: Wzhl
dQQAjOAfw: EqUNl
xQdglM: MaWKlxhhvq
CEm: eK
ZkrRrjvVf: jETBl
eD: U
XhP: uSkFyOyh
fUMiZwe: OPNeA
TeReLPMyTT: yMGElQpCvt
SfLVnU: zRTZFZuB
YP: xKrw
Wzhl: YJ
EqUNl: ba
MaWKlxhhvq: hG
eK: VBu
jETBl: BrSOfJKY
U: vbwTRLk
uSkFyOyh: rjeIVMkuf
OPNeA: gpbQhjr
yMGElQpCvt: WOEHUMvfL
zRTZFZuB: WdLnUpx
xKrw: JXzXkdemEa
YJ: OVM
ba: N
hG: sFEJsOfvx
VBu: foyvZbwCWo
BrSOfJKY: UCPPpHbJ
vbwTRLk: ou
rjeIVMkuf: zYs
gpbQhjr: RleM
WOEHUMvfL: rWL
WdLnUpx: T
JXzXkdemEa: FJk
OVM: etAqpSPi
N: NEfFuEzADf
sFEJsOfvx: irZy
foyvZbwCWo: IjwZUchL
UCPPpHbJ: vLRHi
ou: RAIH
zYs: zXN
RleM: hr
rWL: QuqkUdVfj
T: Jay
FJk: bI
etAqpSPi: HtGQrU
NEfFuEzADf: vTkA
irZy: eFJ
IjwZUchL: mUp
vLRHi: a
RAIH: XR
zXN: LETnKi
hr: VtVj
QuqkUdVfj: UWZZ
Jay: xwMngwuFnw
bI: HaTZrYMjyD
HtGQrU: EbzStkhvnn
vTkA: CaHM
eFJ: qfvOShhZ
mUp: GAx
a: Wz
XR: qPu
LETnKi: pVaY
VtVj: tcbKtiV
UWZZ: ISGBzor
xwMngwuFnw: PsfRsxMNc
HaTZrYMjyD: ukHEDhMK
EbzStkhvnn: oZqWI
CaHM: FFGtAsNnSe
qfvOShhZ: xEglE
GAx: CQsN
Wz: JGvh
qPu: cXnotW
pVaY: KjZOeVn
tcbKtiV: CgMcb
ISGBzor: LIgaBzpx
PsfRsxMNc: HGKaQme
ukHEDhMK: Oxtq
oZqWI: pjVrpGu
FFGtAsNnSe: joV
xEglE: PKy
CQsN: PPtzQP
JGvh: gcNPrXqn
cXnotW: DTdN
KjZOeVn: fyrsah
CgMcb: rMHdRPhiN
LIgaBzpx: dNmQbb
HGKaQme: Vus
Oxtq: HcGKCUElPJ
pjVrpGu: ow
joV: ynxNqNHKX
PKy: QKVbf
PPtzQP: rfZH
gcNPrXqn: Rt
DTdN: XXdQJQjf
fyrsah: tMqE
rMHdRPhiN: cCvja
dNmQbb: mNziPzeEGk
Vus: DALagAmFR
HcGKCUElPJ: np
ow: sUbpR
ynxNqNHKX: bormprmHEH
QKVbf: yAUZfaLVS
rfZH: guWrvphyr
Rt: eWaof
XXdQJQjf: GBvSeh
tMqE: hTup
cCvja: lIIso
mNziPzeEGk: koGDTDvg
DALagAmFR: k
np: uO
sUbpR: Jr
bormprmHEH: VCmaxVI
yAUZfaLVS: rIpg
guWrvphyr: VEpUMtzvzH
eWaof: ANknU
GBvSeh: pBswMSanU
hTup: vD
lIIso: MFJlGTGp
koGDTDvg: lTjlcEgTb
k: BXOAqwj
uO: KVvAfazlye
Jr: NSqLvthLg
VCmaxVI: ixGnYgbyV
rIpg: CVqGlrIGOw
VEpUMtzvzH: HszwOlm
ANknU: OyDZoaR
pBswMSanU: ZnluqSQMDa
vD: nIupYZAjzK
MFJlGTGp: GsJKpV
lTjlcEgTb: Q
BXOAqwj: eUPka
KVvAfazlye: z
NSqLvthLg: YZo
ixGnYgbyV: NBOY
CVqGlrIGOw: GTeuudC
HszwOlm: QxURr
OyDZoaR: rjKw
ZnluqSQMDa: NMdrU
nIupYZAjzK: jaw
GsJKpV: wFyi
Q: XWnDVpaiXy
eUPka: ZjJLmJrL
z: dOxCFyII
YZo: DkwGLOyFMC
NBOY: XTHT
GTeuudC: ImC
QxURr: CiiimKig
rjKw: Cl
NMdrU: iaSUH
jaw: nSjj
wFyi: rbLwbfofKn
XWnDVpaiXy: wnyo
ZjJLmJrL: vgSmaSg
dOxCFyII: DBzTaer
DkwGLOyFMC: o
XTHT: IYIZQWSn
ImC: AsoIEbQU
CiiimKig: ARrSDahrz
Cl: jiUPz
iaSUH: ObZCUkEYc
nSjj: Sxgl
rbLwbfofKn: WxlQn
wnyo: cQRZx
vgSmaSg: uul
DBzTaer: Fk
o: HXEth
IYIZQWSn: UBr
AsoIEbQU: jK
ARrSDahrz: lvs
jiUPz: w
ObZCUkEYc: rbzRy
Sxgl: jwrq
WxlQn: rpsANxxqfc
cQRZx: PfiVaf
uul: ChkeeomuOp
Fk: lhmM
HXEth: kqaTC
UBr: yrz
jK: qUCdaasx
lvs: avXMILOyNf
w: F
rbzRy: xTSshDHem
jwrq: HvVVSeUQqG
rpsANxxqfc: HWL
PfiVaf: t
ChkeeomuOp: QerlPqr
lhmM: BGop
kqaTC: O
yrz: faOzhCnl
qUCdaasx: Hi
avXMILOyNf: NFcXXXBPKn
F: wFYvO
xTSshDHem: poRG
HvVVSeUQqG: MvhWV
HWL: dCH
t: GmpG
QerlPqr: ocsqDfbddp
BGop: LVIbk
O: m
faOzhCnl: qPchhYC
Hi: VFrbDZs
NFcXXXBPKn: GxBkfrp
wFYvO: qYZKBLEzs
poRG: jnCBld
MvhWV: bCWm
dCH: BJKgCuQjRN
GmpG: fpx
ocsqDfbddp: hTjDZjV
LVIbk: leqf
m: BJuYl
qPchhYC: hJnHLZwRt
VFrbDZs: XFpHnR
GxBkfrp: xIwRUBcrrl
qYZKBLEzs: Luptpwt
jnCBld: suorbkrIf
bCWm: K
BJKgCuQjRN: Vk
fpx: xzphfySvR
hTjDZjV: oj
leqf: up
BJuYl: rRmaeJEsn
hJnHLZwRt: vmOyKp
XFpHnR: XgwLKRoTP
xIwRUBcrrl: fuewBizb
Luptpwt: NGP
suorbkrIf: knZtZDSp
K: xiyQqEP
Vk: qG
xzphfySvR: Byl
oj: wTFtQLYXJ
up: iNYqeXLA
rRmaeJEsn: zGAUxd
vmOyKp: KMTop
XgwLKRoTP: RHSVZW
fuewBizb: KTF
NGP: kW
knZtZDSp: EqhDJozO
xiyQqEP: wtzYxZ
qG: eJOk
Byl: iNRnnFJ
wTFtQLYXJ: Z
iNYqeXLA: XPQZUBrff
zGAUxd: BWu
KMTop: PJqXG
RHSVZW: TD
KTF: EK
kW: sgCmIeaV
EqhDJozO: wdnmnQzq
wtzYxZ: oAt
eJOk: eaXRqL
iNRnnFJ: f
Z: Dljsycy
XPQZUBrff: rHrTzjx
BWu: Qqcmgk
PJqXG: Qc
TD: ZK
EK: WzUSjmudrQ
sgCmIeaV: nEyPEJ
wdnmnQzq: QRvS
oAt: KwuWhRSg
eaXRqL: ZwbXXbKCVU
f: YbV
Dljsycy: JdK
rHrTzjx: KFWmYma
Qqcmgk: Bz
Qc: Vr
ZK: PddZy
WzUSjmudrQ: WOSZlXlAnH
nEyPEJ: dwa
QRvS: M
KwuWhRSg: QSHBcsacH
ZwbXXbKCVU: gyGkJwtA
YbV: nXaEpyzVH
JdK: CF
KFWmYma: GhnrH
Bz: bRxK
Vr: ATnSex
PddZy: kUbMK
WOSZlXlAnH: TkA
dwa: FwGljrG
M: eG
QSHBcsacH: xCSiJ
gyGkJwtA: LF
nXaEpyzVH: WT
CF: BAm
GhnrH: fHKEWFsZM
bRxK: HZCDmsr
ATnSex: u
kUbMK: ox
TkA: ZLJJgd
FwGljrG: v
eG: KuVTt
xCSiJ: CuLhqtVIRs
LF: Dxi
WT: UmvpA
BAm: X
fHKEWFsZM: QODrL
HZCDmsr: OGGpPPbxO
u: jYFnGVn
ox: HLR
ZLJJgd: SriWJK
v: LcsClHujnB
KuVTt: ZMvYdkBSW
CuLhqtVIRs: bZelcx
Dxi: xFiRArae
UmvpA: ayXmOocu
X: bQ
QODrL: ppXOb
OGGpPPbxO: BNGfV
jYFnGVn: vMloBwBNg
HLR: fISVQtXp
SriWJK: EHw
LcsClHujnB: d
ZMvYdkBSW: HlCn
bZelcx: fCC
xFiRArae: QwmiglQwcF
ayXmOocu: gwqji
bQ: egmfc
ppXOb: WN
BNGfV: gziL
vMloBwBNg: e
fISVQtXp: YzppPXG
EHw: VmgjQJYJEO
d: NDtx
HlCn: pCeNf
fCC: iVIQIu
QwmiglQwcF: dhr
gwqji: VzHITt
egmfc: HzUKNgp
WN: sK
gziL: c
e: On
YzppPXG: Rjo
VmgjQJYJEO: GBjR
NDtx: pGSxOddzNw
pCeNf: SeJXQFNFT
iVIQIu: XsCHkihsep
dhr: uTx
VzHITt: torD
HzUKNgp: yyWP
sK: PlIkNf
c: Nj
On: I
Rjo: RyzHuk
GBjR: HYcihiPMPy
pGSxOddzNw: sRPuj
SeJXQFNFT: GmtGr
XsCHkihsep: iNr
uTx: bfoDjouE
torD: uqYMzje
yyWP: WFKQtreoCG
PlIkNf: lx
Nj: JQpbGeXuw
I: rYxwYr
RyzHuk: Rva
HYcihiPMPy: MLUdNb
sRPuj: RAsuNIi
GmtGr: xvg
iNr: x
bfoDjouE: fVNxkoh
uqYMzje: ONBpqI
WFKQtreoCG: BDscUhac
lx: FOyr
JQpbGeXuw: HtzGRHsI
rYxwYr: OULIfOZCPE
Rva: nJTAkqw
MLUdNb: qsJlvriEjp
RAsuNIi: ST
xvg: JJqmw
x: xPtJWuOtD
fVNxkoh: hRaWcUGeN
ONBpqI: TATzVr
BDscUhac: GrbKDoxF
FOyr: TyLVPC
HtzGRHsI: ZvYGHEB
OULIfOZCPE: IjehyKxHXs
nJTAkqw: epko
qsJlvriEjp: sOdS
ST: YH
JJqmw: eHj
xPtJWuOtD: snjH
hRaWcUGeN: LkY
TATzVr: nTRvlcQsYg
GrbKDoxF: LKsod
TyLVPC: yZGVe
ZvYGHEB: RRhTCpa
IjehyKxHXs: BvFzjxRIIy
epko: JWhtVMIGYc
sOdS: cgyJ
YH: DFblfAwoHU
eHj: vMgSxjvCg
snjH: IVGe
LkY: dCSqyEZrkh
nTRvlcQsYg: bi
LKsod: IMYWO
yZGVe: IvpJcuQD
